مَزاد	N	auction
عَلَنِي	ADJ	public
لَوحَة	N	painting
دُولار	N	dollar
مُكَرَّر	ADJ	repeated
قَدِيم	ADJ	old
كان	V	be
مَبْلَغ	N	amount
أَكْتَر	ADJ	more
شاف	V	look
سِمِع	V	listen
مَعَ	N	something_with
عَرَف	V	know
خاصَّة	N	elite
يَوم	N	today
حِلْو	ADJ	Gloss
اهْلاً	N	Gloss
اِحْتار	V	be_perplexed
مَوضُوع	N	subject
مُشابِه	ADJ	similar
سَأَل	V	ask
عَنَى	V	mean
باع	V	sell
عالِي	ADJ	high
عِبْرَة	N	admonition
ناس	N	people
حَبّ	V	love
أَحَثّ	V	Gloss
مُخْتَلِف	ADJ	different
غَيْر	N	not
نَفْسِي	ADJ	psychological
ساعِد	V	contribute
لَدَى	N	with
وَفَّر	V	provide
مال	N	money
هَبَل	N	stupidity
عارِف	N	connoisseur
عَمَل	V	function
فِلْس	N	fils_(small_coin)
عِنْد	N	with
أَمْكَن	V	be_possible
مَكان	N	place
ظَرْف	N	charm
قام	V	undertake
زَيّ	N	Gloss
حِكايَة	N	story
طَيِّب	ADJ	good
قال	V	said
اِشْتَرَى	V	buy
اِسْم	N	name
مُمْكِن	ADJ	possible
دَفَع	V	push
زَعَل	N	anger
مَجْنُون	N	crazy_man
مُهِمّ	ADJ	important
عاوِز	ADJ	wanting
هَرَّج	V	befuddle
عُمُوم	N	generality
خِتام	N	conclusion
أَحْلَى	ADJ	sweetest
سَمَع	V	have_listen
شَيخ	N	Sheikh
سَما	N	sky
تَقْرِيب	N	approximation
أَكِّد	V	ensure
قَضَّى	V	carry_out
وِيك	N	week
أُسْرَة	N	family
عايِش	ADJ	living
حَياة	N	life
بابا	N	Pope
اِتْفَرَّج	V	watch
نَشْرَة	N	report
رَدّ	N	reply
ماما	N	mama
جاب	V	explore
واضِح	ADJ	clear
رَبّ	N	lord
وِحِش	ADJ	bad
بَقَى	V	be
مُمَيِّز	ADJ	discriminating
لِبْس	N	clothes
لِبِس	V	wear
قَلِّد	V	mimic
رَقَم	N	number
عارِف	ADJ	knowing
مِتْهَيَّأ	ADJ	Gloss
عَنْد	N	at
اَكِيد	ADJ	Gloss
لازِم	ADJ	necessary
لان	V	be_flexible
أَولَى	ADJ	having_priority
شَكْل	N	manner
طَبِيعِي	ADJ	normal
اِلْتَفَت	V	notice
نَفَس	N	breath
أَخِير	ADJ	last
صَوت	N	vote
ضَعِيف	ADJ	weak
حازِم	ADJ	resolute
مَوجُود	ADJ	present
جَنْب	N	next_to
عَين	N	eye
كُوَيِّس	ADJ	beautiful
سامِع	ADJ	listening
اِتْكَلِّم	V	talk
كِنْز	N	wealth
وَلَد	N	child
إِيد	N	handes
سِنَّة	N	Gloss
سَرَق	V	steal
سَنَة	N	year
اِدَّى	V	condemn
بَرَكَة	N	blessing
اِبْن	N	son
رَبّ	N	lord
بارِك	V	congratulate
لَكْم	N	punching
عَيِّل	N	family
هَوَى	N	affection
مَدْيُون	ADJ	indebted
اَيّ	N	any
واحِد	N	one
صاع	V	cheat
أَبّ	N	father
وِشّ	N	face
طُول	N	length
حَرامِي	N	thieves
لِعِب	V	play
كَفَّى	V	suffice
مِتَلتِل	ADJ	numerous
عَدّ	V	count
حافِظ	V	preserve
زَوِّد	V	augment
كَمان	ADJ	Gloss
أَجَل	N	period
رَوح	N	repose
اِرْتاح	V	rest
سَمَّى	V	name
قِلِق	V	worry
أَوِّل	V	explain
حِلِف	V	swear
يِمِين	N	right_side
غَيَّر	V	change
رِجِع	V	go_back
مَلِكَة	N	queen
مَصْرِي	ADJ	Egyptian
مَفْهُوم	ADJ	understood
خَشّ	V	enter
جَيش	N	army
شُرْطَة	N	police
وَعَى	V	be_aware_of
خَرَج	V	go_out
ساتِر	ADJ	covering
مَلَل	N	boredom
عَيب	N	shame
كَلِّم	V	talk
كِدَه	N	Gloss
هَزَّر	V	joke
أُمّ	N	mother
خَدَم	V	serve
اِخْلاص	N	fidelity
آَخِرَة	N	hereafter
سْوَى	V	Gloss
مَسَك	V	seize
إِلَه	N	instrument
حاسِب	N	calculator
كِتِير	ADJ	numerous
اِتْصَرَّف	V	manage
أَرْضَى	V	satisfy
تَلات	N	Tuesday
خُسارَة	N	casualty
غالِي	ADJ	expensive
جِه	V	occur
مَيَّة	N	hundred
شَمالِي	ADJ	Northen
بَحْر	N	sea
قَناة	N	canal
دَخْل	N	income
صَدَقَة	N	alms
جارِي	ADJ	current
مَخْبُول	ADJ	insane
نُصّ	N	half
اَخَد	V	take
كَلام	N	speech
طَلَّع	V	oust
فَقِير	ADJ	poor
مِسِك	V	refrain_from
آَلَة	N	instrument
حَدّ	N	stop
جِنَيه	N	pound_(currency)
سِيُولَة	N	liquid_state
سَمَح	V	allow
نَفَع	V	be_useful_to
غَجَرِي	N	gipsies
عَجَب	V	delight
مال	V	lean
مُجْرِم	N	criminal
خَلَّى	V	release
فَرَّط	V	abandon
شِمال	N	left
صَلَّى	V	pray
صَراحَة	N	sincerity
قَبَل	V	agree
هَمّ	V	be_ready
أَنْكِل	N	uncle
عِلِي	V	be_elevated
مِتْبَرِّي	ADJ	Gloss
حافِظ	ADJ	guardian
وَصَّى	V	recommend
عامِل	ADJ	active
سِتّ	N	lady
حاطِط	ADJ	Gloss
أَرْض	N	earth
عُمْر	N	age
اِستَجرَى	V	dare
رَفَع	V	lift
ماسِك	ADJ	grabbing
حَدِيد	N	iron
خَجُول	ADJ	shy
كُلّ	N	all
حاضِر	ADJ	present
عايِز	ADJ	wanting
حَكَى	V	relate
حاكَى	V	imitate
هاتَى	V	bring
اِيطالِي	ADJ	Italian
صَوَّر	V	draw
حاسبَة	ADJ	computer
كَلِّف	V	cost
آَخِر	N	end
لَمّ	V	collect
مَعْقُول	ADJ	plausible
شَرِكَة	N	company
اَجْنَبِيَّة	ADJ	Gloss
مَدْفَع	N	Gloss
شال	V	carry
نَعْش	N	coffin
رَشّاش	N	water_hose
آَسِف	ADJ	sorry
كُفْر	N	infidelity
كِتِير	N	numerous
رَحَم	V	have_mercy
بِنْت	N	daughter
حَجَّة	N	Gloss
عَصْرِيّ	ADJ	modern
جامِد	ADJ	frozen
وِصِيَّة	N	testament
مَصِير	N	path
رايِح	ADJ	going
رَحْمَة	N	compassion
حَدِّد	V	specify
شَعْب	N	people
فِضِل	V	be_preferable
ساكِت	ADJ	silent
حَصَل	V	obtain
طَمِّن	V	assuage
سَتَر	V	cover
خَلاص	N	deliverance
عِزْبَة	N	farm
كَتَب	V	write
عُمْلَة	N	currency
وَرَقِيّ	ADJ	paper
اَبَد	N	Gloss
صَدَّق	V	believe
قَرَّب	V	bring_close
اَوَى	N	Gloss
تَعَب	V	tire
شُوَيَّة	N	a_little_bit
حِوار	N	conversation
مُمْتِع	ADJ	pleasing
حاسِب	ADJ	calculator
وَقْت	N	time
ناقِص	ADJ	incomplete
حُبّ	N	love
ناقِص	N	incomplete
تانِي	ADJ	second
كُلّ	N	all
أَوَّل	ADJ	first
مُشارْكَة	N	association
رِضاً	N	approval
إِيمان	N	belief
تَوفِيق	N	success
أَخّ	N	brothers
شَأْن	N	matter
حِين	N	time
صُورَة	N	picture
اِتْنَفِّس	V	breathe
قِدِر	V	able_to
شِرِب	V	drink
قَلْب	N	overthrowing
عَرَبِي	ADJ	Arabs
دَخَل	V	enter
لاقَى	V	meet
نَفْس	N	same
حَيَوِيَّة	N	vigor
فَرْق	N	difference
عاش	V	live
اَكَل	V	Gloss
نام	V	sleep
عَمَلِيَّة	N	operation
بِيُولُوجِيّ	ADJ	biological
اِخْتار	V	choose
حَسِّس	V	make_feel
مُتْعَة	N	pleasure
جُوَّه	N	inside
اِشْتَغَل	V	work
طُمُوح	N	craving
مُعَيَّن	ADJ	fixed
مَفْرُوض	ADJ	imposed
مَطْلُوب	ADJ	required
رَضَى	V	agree
كِلْمَة	N	talk
عارِف	ADJ	knowing
شاف	N	Gloss
أَمْر	N	matter
مَظْبُوط	ADJ	established_facts
حَبَّة	N	seed
دُخُول	N	entrance
قَرَّر	V	decide
سَفَر	N	travel
قابِل	V	meet
أَغْلَى	ADJ	costlier
بال	N	mind
مَصْرِي	N	Egyptian
سَعُودِيّ	ADJ	Saudi
تَحْذِير	N	warning
عَرَبِيَّة	ADJ	Gloss
شَهادَة	N	certificate
بَعْض	N	together
نَكَر	V	deny
رِيحَة	N	smell
فايِح	ADJ	with_good_smell
عائِش	ADJ	living
سَعُودِيّ	N	Saudi
بِتاع	N	thing
مُشْكِلَة	N	problem
اَغْلَبِيَّة	N	majority
مَدْرَسَة	N	school
دايْم	N	Gloss
مِصْرِيّ	ADJ	Egyptian
بِعِد	V	go_away
شُغْل	N	work
جايّ	ADJ	Gloss
دِماغ	N	brain
طَرِيقَة	N	method
بَلَد	N	country
فِكْرَة	N	idea
عامّ	ADJ	general
أَصْلَح	V	put_in_order
حال	N	situation
غَرِيب	ADJ	strange
صَحِيح	ADJ	true
كِفايَة	ADJ	sufficiency
فِيلم	N	film
وَطَنِيّ	ADJ	national
كِدَة	N	this
صَلاة	N	prayer
أَحَد	N	one_(of)
قَصِيدَة	N	poem
سَبّ	V	curse
رابِط	ADJ	tying
عَزِيز	ADJ	dear
شايِف	ADJ	i_see
نَظَر	N	view
تَمام	ADJ	exact
رَأْي	N	opinion
حُرّ	ADJ	free
حاسِس	ADJ	feeling
وِقِف	V	top
طَبُور	N	columns
عَيش	N	life
رِغِيف	N	a_loaf_of
أَهْل	N	family
مَحْسُوبِيَّة	N	patronage
اِسْتَفَزّ	ADJ	Gloss
دافِع	V	defend
اِعْتَقَد	V	believe
جَمِيع	N	all
لَوِّن	V	colorize
اِسْتَحَى	V	be_ashamed
شَيّال	N	porter
حَضْرَة	N	presence
ضَهْر	N	summit
طِلِع	V	exit
فَجْر	N	dawn
يُومِيَّة	N	daily_wage
دَولَة	N	state
ضَرَب	V	strike
مُلْتَزِم	ADJ	committed
وَزَّع	V	distribute
كِتاب	N	book
اِضْطَرّ	V	oblige
لِحْيَة	N	beard
ظَنّ	V	think
مَرَّة	N	occasion
دايِر	ADJ	current
شايِل	ADJ	Gloss
مِرَبِّي	ADJ	educator
مِتْغَرَّب	ADJ	westernized
بَيت	N	house
اِتْجَوِّز	V	marry
اِتغَرَّب	V	be_westernized
صاحِب	N	owner
بَرَّه	N	outside
شَحَّت	V	ask_for_alms
ضاع	V	emanate
تافِه	ADJ	trivial
اِتْعَرَض	V	face
نايِم	ADJ	sleeping
مِتْنِعِم	ADJ	blessed
ساب	V	flow
أَقْصَى	ADJ	most_extreme
عِرِف	V	be_known
راح	V	begin
مُسْتَودَع	N	repository
ساعَة	N	hour
شَهْر	N	month
اِتْصَوَّر	V	think
رَكِّب	V	install
حَنَفِيَّة	N	faucet
عَشا	N	dinner
فِلُوس	N	moeny
اِتْوَفَّى	V	take_to_Heaven
طِفْل	N	child
خامِس	ADJ	fifth
اِبْتِدائِي	ADJ	elementary
شَيل	N	carrying
مَحْجَر	N	infirmary
حَجَر	N	stone
جاي	ADJ	coming
سِياسَة	N	politics
تَهْيِيج	N	agitation
أُمَّة	N	nation
وَلِيّ	N	successor
مُشاهْدَة	N	observation
ضَغَت	V	press
مُسْلِم	N	Muslim
مُتَيَقِّن	ADJ	convinced
قِبْطِيّ	ADJ	Coptic
عَلِّم	V	educate
اِنْتِقاد	N	censure
تَشْنِيع	N	defamation
لَعْن	N	cursing
قَلِيل	ADJ	little
رَأَى	V	see
حَسَب	N	according_to
حَمَد	V	thank
أَدْهَى	ADJ	Gloss
أَعْطَى	V	give
إَتَى	V	arrive
عام	N	year
قَصَّر	V	shorten
وَجَد	V	find
طَرِيق	N	road
اِتْشَرَّف	V	be_honored
عِنْوان	N	headline
رَدّ	V	answer
اِتْعَرَّف	V	become_acquainted_with
اِقْتِصاد	N	saving
عَدِيد	ADJ	numerous
رَغْم	N	in_spite_of
حَرْب	N	war
قَمْح	N	wheat
سَنَوِي	ADJ	yearly
قارِن	V	compare
عالَم	N	world
ذَرِّيّ	ADJ	atomic
مَرْحَلَة	N	phase
قَدِّم	V	advance
دُسْتُور	N	constitution
عَبّارَة	N	Gloss
سِرْقَة	N	stealthily
نِسْبَة	N	ratio
بِطالَة	N	idleness
آن	N	time
تَعْذِيب	N	torture
قِسْم	N	portion
مات	V	die
أَتَى	V	arrive
أَمْر	N	matter
خاطِئ	ADJ	mistaken
وَصِي	N	authorized_agent
جَهْل	N	ignorance
فَقْر	N	poverty
ذُلّ	N	humiliation
مِسِيحِي	ADJ	christian
شَخْص	N	individual
دِينِيّ	ADJ	religious
حُكُومَة	N	government
مُنْتَدَى	N	conference
فَتَح	V	open
كَذا	N	such
كُوَيِّس	N	good
بَدَأ	V	start
رِياضَة	N	sport
كَبِير	ADJ	large
صِحِي	V	wake_up
بَدْرِي	ADJ	Gloss
رِجْل	N	leg
حُرِّيَّة	N	freedom
مَكْفُول	ADJ	guaranteed
حَقّ	N	truth
صُورَة	N	picture
تَفاهُم	N	mutual_understanding
تامّ	ADJ	complete
اِتْفاهِم	V	agree
مُتَحَضِّر	ADJ	civilized
تَعَصُّب	N	fanaticism
ظَهْر	N	back
مَثَل	N	example
عَدَّى	V	traverse
مَساج	N	massage
ظاهِر	ADJ	evident
تَعْبان	ADJ	tired
شُوَيَّة	ADJ	Gloss
صَرْف	N	diverting
صِحِّي	ADJ	sanitary
دَلّ	V	point
تَقَدُّم	N	progress
مِلَفّ	N	file
وَقَف	V	stop
كَمِّل	V	carry_on
طار	V	fly
مِتْدَلَّع	ADJ	Gloss
جا	V	came
جَدِيد	ADJ	new
ناوِي	ADJ	Gloss
شَرْط	N	precondition
فَهْم	N	understanding
آَخَر	ADJ	other
بَسّ	ADJ	Gloss
واهِد	N	one
أَوِي	ADJ	very
أَصْل	N	origin
شِوَيَة	N	a_little
قَعَد	V	sit_down
بَقِي	V	remain
شِوَيَّة	N	little
بَعْدَين	N	then
فاهِم	ADJ	understanding
عاجِب	ADJ	delight
رَوَّح	V	fan
مُتَّفَق	ADJ	agreed
إِقْتِباس	N	adaptation
حارِب	V	wage_fire
عَرَبِيَّة	N	Arabic_(language)
رِئَة	N	lung
وَحِيد	ADJ	only
مُوصَد	ADJ	closed
بَرْضُه	N	Gloss
خَطِر	ADJ	serious
إِتْبَرَّع	V	contribute
حَلّ	V	dissolve
غَنَى	V	sing
شاطِر	ADJ	clever
اِسْتاهِل	V	deserve
جِهَة	N	side
يِمِين	ADJ	right
رُصاصَة	N	bullets
سَيّارَة	N	car
مُحَمَّل	ADJ	loaded
كَدّاب	ADJ	lying
جِزِيرَة	N	island
اِذاعَة	N	stations
غَزَّة	N	stab
دَرَجَة	N	degree
واحْدَة	ADJ	Gloss
مَصْلَحَة	N	interest
دايِق	V	annoy
قافِلَة	N	convoy
شُرْيان	N	artery
اِسْتَفاد	V	make_use_of
حَرام	N	sin
سَوَء	V	worsen
سُمْعَة	N	reputation
تِلِفِزْيَون	N	Gloss
خارْجِيَّة	N	ministry_of_foreign_affairs
اِتحَدَى	V	defy
وَحْد	N	alone
أَدْنَى	ADJ	lower
اِنْصاف	N	impartiality
جَمَّع	V	accumulate
حَدَث	V	happen
نَقْل	N	transportation
شَخْصِيّ	ADJ	private
مُسَبَّق	N	Gloss
مَنَع	V	prevent
مُساعْدَة	N	help
اِسْتَشْهِد	V	seek_a_witness
مُمْكِن	N	possibilities
مُنْتَهَى	N	utmost
سُهُولَة	N	ease
طَلْقَة	N	a_piece_of_lead
بُنْدُقِيَّة	N	rifle
مِيرِي	ADJ	legal
قَتَل	V	kill
اِتْمَنَّى	V	hope
زَعَّل	V	annoy
مُلاحِظ	N	observer
مِتْحامِل	ADJ	mistreating
سِياسِي	ADJ	political
أَحَبّ	V	love
حِصار	N	siege
فَرَّق	V	separate
حاوِل	V	try
تَمْثِيلِيَّة	N	soap_opera
عَدِوّ	N	enemy
ظَلَم	V	oppress
قافِل	ADJ	closing
فَكَّر	V	think
بَقّ	V	be_bounteous
جُزء	N	section
اِعْتَبَر	V	believe
باب	N	door
قَفَل	V	return
جَمْب	N	side
قِيمَة	N	value
هات	V	give
صَحِيفَة	N	newspaper
عِدلَة	ADJ	correct
واحِد	ADJ	one
اِتَقَى	V	beware
خالَة	N	maternal_aunt
جُنْدِي	N	soldiers
أَعْوَر	ADJ	one_eyed
شَهِيد	N	martyr
فِرْقَة	N	group
حَقِيقِيّ	ADJ	true
عَلَم	N	flag
مِتْعَلَّق	ADJ	attached
سِلِّم	N	ladder
مِسْتَنِّي	ADJ	waiting
وَقَّف	V	stop
هان	V	be_insignificant
حالَة	N	condition
جَرِيح	N	wounded
قائِد	N	leader
شِقِيق	N	brother
آَن	N	time
شِقِيقَة	N	sister
مَثَّل	V	represent
اِعْتِداء	N	assaults
تَوَجُّه	N	attitude
اِشْتِباك	N	clashes
قَتْل	N	murder
اِنْقِلاب	N	coup
اِسْوِد	ADJ	black
حَمساوِي	ADJ	of_Hamas
مُبارَك	N	blessed
سَحْقَة	N	crushing
مُحِبّ	ADJ	loving
جَماعَة	N	party
فِتْنَة	N	sedition
واخِد	ADJ	arrest
غَلَق	N	padlock
جِدار	N	wall
شَوِّه	V	be_deformed
مَأْجُور	ADJ	salaried
اِسْلام	N	Gloss
شَيء	N	something
قَبْل	N	before
دَمّ	N	ointment
غاز	N	gas
فَعَل	V	do
دارَى	V	flatter
عَمِيل	N	agent
مُجَرَّد	ADJ	bare
اِتْعَمَل	V	function
كِرِه	V	detest
وافِق	V	agree
اِتْخَيِّل	V	let_go
حَلِّل	V	analyze
عَمِّل	V	produce_pus
نَشَف	V	absorb
نَظْرَة	N	look
تَحْلِيلِيّ	ADJ	analytical
باس	V	kiss
رَجَّع	V	send_back
اِقْتِصادِي	ADJ	economic
رِسالَة	N	letter
أَمْرِيكِي	ADJ	American
بْرِيطانِي	ADJ	Gloss
اِفْتَكَر	V	reflect
اَمْرِيكانِي	ADJ	Gloss
فِيَتْنامِيّ	ADJ	Vietnamese
تُهْمَة	N	accusation
قُرَيِّب	ADJ	immediate_future
مُقاوْمَة	N	Gloss
تَمّ	V	conclude
لِعْبَة	N	sport
فَرَق	V	differentiate
سَدّ	V	block
قَتْلَة	N	a_killing
اِتْكَسَف	V	be_ashamed
سِلِم	V	be_faultless
فَتْح	N	opening
ثانْيَة	N	seconds_(time_span)
مُشْتَبَه	ADJ	suspicious
مُتَّهَم	ADJ	accused
قِبِل	V	receive
وَفَّق	V	grant_success
شاء	V	want
جُثَّة	N	corpse
نِفاق	N	expenditure
شابّ	N	young_man
عِمِل	V	function
إِنْتَخَب	V	choose
مُناسِب	ADJ	suitable
غَسِيل	N	clothes
مَعْسُول	ADJ	sweetened
بِدايَة	N	beginning
قَدَّر	V	estimate
سَعَى	V	strive
تَعْدِيل	N	adjustment
حَلّ	N	solution
رِئاسَة	N	presidency
عِدَّة	N	several
هُجُوم	N	attack
اِسْتَمَرّ	V	last_(time)
حُكُومِيّ	ADJ	governmental
بَلْطَجَة	N	bulliying
تَشْوِيه	N	distortion
رَفْض	N	rejection
رَقابَة	N	censorship
دَوْلِيّ	ADJ	state
خَوف	N	fear
اِنْتِخاب	N	selection
كامِل	ADJ	complete
نَزاهَة	N	impartiality
اِعْتَرَف	V	confess
اِنْتِشار	N	spreading
مُنْقِذ	N	rescuer
مُسَلْسَل	N	serial
اِسْتِعْباد	N	slavery
جُرُوب	N	groups
كِبِير	ADJ	large
فِيس	N	face
اِخْتِيار	N	selection
اثْناء	N	during
وِكالَة	N	agency
طَبَّق	V	apply
مَلْحُوظَة	N	observation
مَشْكُور	ADJ	praiseworthy
عالِم	N	scientist
تابِع	ADJ	subordinate
أَساس	N	foundation
تَنْفِيذ	N	implementation
حَرَّك	V	make_move
نَفِّذ	V	implement
شُيُوع	N	spreading
شُعُور	N	feeling
تَجْرِيح	N	surgery
اِساءَة	N	insult
اِهانَة	N	contempt
اَخِير	ADJ	latest
تارَة	N	once
مَصْلَحَة	N	interest
مَمْنُوع	ADJ	prohibited
كُوفِيَّة	N	kaffiyeh
فِلَسْطِينِيّ	ADJ	Palestinian
كاتِب	N	writer
ضِحِك	V	laugh
بِتاعَة	N	Gloss
جامْعَة	N	universities
فَهِّم	V	make_understand
واقِع	N	fact
اِنْتَظَر	V	wait
مُساعَدَة	N	assistance
مِسْتَغْرَب	ADJ	finding_strange
قِصَّة	N	story
رِضِي	V	accept
غَبِي	ADJ	stupid
ضالّ	ADJ	misguided
مُراقْبَة	N	Gloss
لَصِيق	ADJ	clinging
فَتْرَة	N	phase
طَوِيل	ADJ	tall
مِتْعاطِف	ADJ	sympathizing
قَضِيَّة	N	problem
تَعاطُف	N	mutual_sympathy
اِشْتَكَى	V	complain
دِين	N	religion
لُغَة	N	language
عُرُوبَة	N	Arabism
ضِدّ	N	contrary
صَهْيُونِيَّة	N	Zionism
مِتْمَرْكِز	ADJ	Gloss
سافِر	V	travel
مَلَفّ	N	letter_file
دَرَس	V	study
تابِع	V	follow
قَصَد	V	intend
مِحْتاج	ADJ	needing
مَعْهَد	N	institute
اِحْتِرام	N	respect
مِفَبْرِك	ADJ	Gloss
مَنْطِقِي	ADJ	logical
فارِق	N	difference
مُسْلِم	ADJ	Muslim
تُجاه	N	towards
مُضْطَهَد	ADJ	persecuted
غَزَل	N	flirtation
أَكْسَب	V	impart_to
بَرّاق	ADJ	flashing
مُباغِت	ADJ	sudden
قَرارَة	N	bottom
اِنْتَهَى	V	end
سِياحَة	N	tourism
شَقِيقَة	ADJ	fraternal
طَبِيب	N	physician
لَفْظ	N	word
تَطاوُل	N	insolence
خارِجِيّ	N	outside
وَصَل	V	arrive_at
كِبِر	V	grew_up
عَرَبِي	N	arabs
صِفَة	N	attribute
خاصّ	ADJ	special
فَتْوَى	N	fatwa
قَزِر	ADJ	dirty
مُقَزَّز	ADJ	disgusting
ذال	V	stop_doing
خارِجِيّ	ADJ	foreign
ظَهَر	V	appear
عِصابَة	N	gang
صُغَيَّر	ADJ	young
جِهاد	N	Jihad
فَقَد	V	lose
عَدَم	N	absence_of
قُدْرَة	N	capacity
سَيطَرَة	N	control
رُجُوع	N	return
شُقَّة	N	distance
حَمّام	N	bath
طَلَب	V	request
تَعْلِيم	N	education
راجِع	V	consult
زِراعَة	N	agriculture
زِراعِيّ	ADJ	agricultural
رَيّ	N	irrigation
مَرّ	V	pass
كَهْرَبَة	N	electricity
تَخْطِيط	N	planning
بَسِيط	ADJ	simple
صالِح	N	advantage
عام	ADJ	general
أَزْمَة	N	crisis
آخِر	ADJ	last
اِتِّحاد	N	union
كُرَة	N	ball
شَباب	N	young_man
جُمْهُور	N	multitude
اِتَّفَق	V	agree
كُرْسِي	N	seats
مُعارِض	ADJ	opposing
سَفاهَة	N	stupidity
مُباراة	N	match
كاس	N	cup
خَفَى	V	hide
شَجَّع	V	encourage
حَسْرَة	N	grief
فَرِيسَة	N	victim
آتِي	ADJ	coming
نادَى	V	announce
اِنْهَزَم	V	be_defeated
هَزِيمَة	N	defeat
نَجَح	V	succeed
مَهانَة	N	contempt
اِبْتِدائِيّ	ADJ	preparatory
حاصِل	ADJ	holding
دُكْتُوراه	N	Gloss
خِيرَة	N	choice
أَدِيب	N	writer
بَقاء	N	survival
تَدَنِّي	N	decline
أَخْرَج	V	remove
مُخَدِّر	N	anesthetic
أَعْظَم	ADJ	greater
مُواطِن	N	citizen
غَلْبان	ADJ	needy
ضَحِيَّة	N	victim
مَلْبَس	N	clothes
مُوَظَّف	N	employee
كَل	V	eat
رَهِيب	ADJ	dreadful
تَضَخُّم	N	inflation
حُصُول	N	acquisition
كَرامَة	N	dignity
فِعْلِيّ	ADJ	actual
صاحِب	N	owner
مُنَظَّمَة	N	organization
تَفاوُت	N	disparity
مُتَفاوِت	ADJ	different
اِضْطِهاد	N	persecution
عُنْصُرِيَّة	N	racism
ظُلْم	N	injustice
حَجْم	N	volume
كَرَّر	V	repeat
مُشْتَرَك	ADJ	shared
مِثْل	N	like
قَبِل	V	accept
عَودَة	N	return
مُبارَة	N	game
عُضْو	N	member
مَطش	N	game
كَورَة	N	ball
اِتْحَوِّل	V	be_changed
شَتْم	N	abuse
خِصام	N	confrontation
ساعَة	N	hour
اِسْتِعْمار	N	colonization
مَلاك	N	foundation
تَخَيَّل	V	imagine
بَعَت	V	send
طائِرَة	N	aircraft
عَسْكَرِي	ADJ	military
مَطْوَة	N	hour
كَسَر	V	break
اِتْدَخَّل	V	interfere
صَحّ	ADJ	right
مَلْطَشَة	N	butt
دَور	N	role
اِتْساهِل	V	be_indulgent
حَرَق	V	burn
هِدِي	V	calm_down
فِهِم	V	uderstand
طَرَف	N	participant
حَلَى	V	adorn
بِه	N	ba
فاكِر	ADJ	remembering
إِعْلام	N	information
قَوِي	ADJ	strong
وَصَّل	V	connect
حَقِيقَة	N	truth
نَظَّم	V	arrange
خِطَّة	N	plan
خَطْوَة	N	step
ماتْش	N	match
جَرَى	V	occur
شارِع	N	street
رُعْب	N	fright
مَلْعُون	ADJ	cursed
اَبُو	N	father
ضَيَّع	V	lose
واثِق	ADJ	certain
قادِر	ADJ	capable
صُدْفَة	N	chance
بَرْنامِج	N	Gloss
اِخْتِراق	N	crossing
مُهِمّ	N	main_thing
سِلْسِلَة	N	chain
بَلَّغ	V	communicate
مادَّة	N	substance
غِذائِيّ	ADJ	food
خَد	V	receive
تَجَسُّس	N	espionage
اِسْتَغْرَب	V	wonder_at
اَكِيد	N	Gloss
كَنّ	V	conceal
جاسُوس	N	spy
خَبَر	N	news
جِمِيل	N	favor
مِدايِق	ADJ	troublesome
ضارّ	ADJ	harmful
بَساطَة	N	frankness
سَذاجَة	N	naivet
راحَة	N	rest
لازِم	N	necessary
اِتْجَسِّس	V	reconnoiter
اِحْتِلال	N	occupation
فِكْرِيّ	ADJ	intellectual
بَطَّل	V	thwart
جُمْعَة	N	Friday
جَمِيل	ADJ	beautiful
تَفْرِيج	N	alleviating
سَبِّب	V	produce
قَلَق	N	unrest
اِهْتَمّ	V	be_interested
بِرْنامِج	N	program
اِصْلاح	N	reforms
قَوَّى	V	strengthen
مُوَجَّه	ADJ	directed
اِسْلامِي	ADJ	Islamic
هَدَى	V	guide
حَسَم	V	cut_off
دَخْلَة	N	Gloss
غِلِي	V	boil
طَعْم	N	taste
مُرّ	ADJ	bitter
مُواجْهَة	N	confrontation
سُنِّيّ	ADJ	Sunni
بُدّ	N	escape
مِحارْبَة	N	struggle_against
جُمْرُك	N	customs
خارِج	ADJ	outside
قَناعَة	N	satisfaction
وَضَّح	V	clarify
رُؤْيَة	N	vision
وَجِّه	V	directed
مَقام	N	place
اِعْتَمَد	V	depend
شَخْصِيَّة	N	identity
عِلِم	V	know
خالِف	V	contrast
تَغْيِير	N	change
خُطْبَة	N	speech
بِقِي	V	remain
أُخْت	N	sister
مَزْعُوم	ADJ	alleged
مَكْر	N	deception
قاد	V	lead
حَذَّر	V	warn
تَعامُل	N	relations
أَعْلَن	V	announce
تَمْدِيد	N	extension
عُقُوبَة	N	punishment
دَعْوَة	N	call
اِسْتِيطان	N	settlement
مُسْتَمِرّ	ADJ	continuing
تَهْوِيد	N	Judaization
جِدِيد	ADJ	new
وِدّ	N	friendship
مُدِير	N	director
مُخابَرات	N	Gloss
شَرَف	N	honor
عَظِيم	ADJ	great
حَلال	N	permissible
شَغّال	N	laborer
ضَغَط	V	press
جايْزَة	N	rewards
حَساسِيَّة	N	sensitivity
جِهاز	N	machine
صَعْب	ADJ	difficult
تَعاوُن	N	cooperation
إِستِخباراتي	ADJ	intelligence
إِتعَدَى	V	Gloss
دَمْعَة	N	teardrop
حُزْن	N	sadness
زِيادَة	N	increase
فاضِل	ADJ	honorable
سَيِّب	V	leave_alone
صَحافَة	N	journalism
مُبالِغ	ADJ	exaggerating
حَقَّق	V	achieve
عَدالَة	N	justice
اِخْتِصار	N	shortening
شَرِيحَة	N	slice
عُلِيَّة	N	upper_room
قاس	V	measure
أَشار	V	indicate
كارِثِيّ	ADJ	catastrophic
صَرَّح	V	declare
مُهَنْدِس	N	engineer
اِجْتِماعِي	ADJ	social
اِحْتِياطِي	ADJ	precautionary
مَحَلِّي	ADJ	local
مُدَّة	N	period_of_time
قادِم	ADJ	arriving
فِبْرايِر	N	February
مُقْبِل	ADJ	next
اِحْتِياطِي	N	spare_wheel
زِراعِي	ADJ	farming
طَوِّل	V	not_be_lengthy
سَيِّئ	ADJ	awful
غايَة	N	goal
جَنَّة	N	paradise
حادْثَة	N	incident
اِعْداد	N	preparation
سَلامَة	N	security
تَقَبَّل	V	receive
حاكِم	ADJ	ruling
نِسْر	N	eagle
دِلْوَقْتِي	N	Gloss
عادِي	ADJ	aggressive
يَد	N	hand
إِنْسان	N	human_being
تَنْمِيَة	N	development
مَزِيد	N	more
فاسِد	ADJ	corrupt
صَحّ	V	be_correct
مُؤْتَمَر	N	conference
سادِس	ADJ	sixth
فاضِي	ADJ	empty
تَهْمِيش	N	sidelining
قَطْع	N	breaking_off
تَمْوِيل	N	financing
تَمْهِيد	N	preparation
مَدَنِي	ADJ	civil
هِدُوء	N	calm
شَخْصِي	ADJ	private
مَجَرَة	N	badge
دَرْب	N	path
تَبّانَة	N	Gloss
صادِر	N	exports
مُدَّخَر	N	savings
مَهُول	ADJ	senior
اِسْتِثْمار	N	investment
اِحْتِياطِي	N	spare_wheel
زاد	V	increase
وَرَقَة	N	sheet
مُنْتَصَف	N	middle
نَظَرِيَّة	N	theory
اِخْتِراع	N	invention
وَكْسَة	N	drop_in_value
اِحْتاج	V	be_in_need
بَصّ	V	look
مِسافِر	ADJ	traveler
نِزِل	V	get_down
ذِكْر	N	mention
خارِج	N	outside
عادَة	N	habit
اِسْتِهْلاك	N	consuming
عُقْدَة	N	complex
زَواج	N	marriage
شَقَّة	N	apartment
حُجْرَة	N	room
صالَة	N	hall
اِسْراف	N	Gloss
مَظْهَر	N	appearance
تَعَدَّى	V	overstep
طَمَع	N	greed
جَشَع	N	greed
بِقالَة	N	grocery
حارَة	N	quarter
بَعْض	N	some
سَوّاق	N	chauffeur
تاكْسِي	N	taxi
أُتُوبِيس	N	bus
نَقّاش	N	painter
سَبّاك	N	plumber
قِطْعَة	N	piece
غِيار	N	exchange
صِيانَة	N	maintenance
خِبْرَة	N	experience
تَحَسُّن	N	improvement
خِدْمَة	N	service
حَبِيب	N	dear
اِسْتِقْرار	N	stability
سِي	N	mister
خَراب	N	ruins
مَسْطَرَة	N	sample
نَهْب	N	looting
بَيع	N	sale
ضَياع	N	loss
مَكانَة	N	position
تَيفُود	N	typhoid_fever
مَرَض	N	disease
رَشْوَة	N	bribe
سَطْوَة	N	assault
سُلْطَة	N	power
خَلَى	V	be_evacuated
صَلَّح	V	put_in_order
أَزال	V	remove
مُحْتاج	ADJ	in_need
مُدَرِّس	N	instructor
ضَمِير	N	conscience
اِحْتِفاظ	N	safeguarding
تَوفِير	N	provision
اِنْتَشَر	V	spread
أَسِف	ADJ	sorry
اِعْتِراف	N	confession
اِهْمال	N	neglect
ثَقافَة	N	culture
خِلِص	V	end
قاعِد	N	sitting
قَدّ	N	size
تَطْوِير	N	development
مُكافْأَة	N	reward
صَرَف	V	divert
نُمُوّ	N	development
أَكْبَر	ADJ	larger
مَورِد	N	source
عِنايَة	N	care
اِلْف	N	familiarity
اِسْتِقالَة	N	resignation
جِدِّيَّة	N	seriousness
كارْثَة	N	tragedies
اِتْغَيَّر	V	be_changed
اِسْتَخْدِم	V	employ
فَرْحَة	N	joy
قِلَّة	N	scarcity
سَلِّم	V	pass
مَسْئُول	N	responsible
اِسْتَقال	V	resign
هِرِب	V	run_away
عُقْب	N	consequence
مَرْكَزِي	ADJ	central
مَشْهُور	ADJ	famous
داخْلِيَّة	N	interior
مُدَبَّر	ADJ	deliberate
أَدَّى	V	direct
ثِقَة	N	trust
سَحَب	V	withdraw
سَكَت	V	be_silent
بَيّاع	N	salesman
فَرَح	N	joy
رَيِّس	N	captain
قَرا	V	pierce
حِتَّة	N	morsel
فُنْدُق	N	hotel
جُولف	N	golf
مُوسِيقَى	N	music
لَيل	N	night
قاعَة	N	hall
مِتْكَلِّف	ADJ	costs
رُبْع	N	quarter
كُتْر	N	abundance
نِفْس	N	hope
فُسْتان	N	dress
خاتِم	N	ring
جَواز	N	permit
فِرِح	V	rejoice
فَظِيع	ADJ	hideous
عِشّ	N	nest
زَوجِي	ADJ	paired
مُتَواضِع	ADJ	humble
زَمالكَوِي	ADJ	someone_living_in_Zamalek
يَتِّم	V	orphan
رَزَق	V	bestow
ذُرِّيَّة	N	descendants
صالِح	ADJ	suitable
دَعا	V	call
خِمَيسَة	N	Gloss
عَمّ	N	paternal_uncle
شَقِي	ADJ	monstrous
عَمَّر	V	populate
مُحْتَرَم	ADJ	esteemed
بَقِيَّة	N	remainder
مُكَلِّف	ADJ	costly
شَهِير	ADJ	famous
قَرَف	N	loathing
ظَبْط	N	adjusting
كُلْفَة	N	cost
اِتْكَلِّف	V	cost
أَجَّر	V	lease
حَلَق	N	rings
حَضَر	V	attend
مُقتَصِد	ADJ	economic
ساهِم	V	contribute
خَرَب	V	destroy
اِتْجَوَز	V	allow
مِدَلِّل	ADJ	Gloss
شُكْر	N	thankfulness
صُبْح	N	morning
مَصْرُوف	ADJ	spent
مُتَكَلَّف	ADJ	formal
شِوَيَّة	ADJ	little
مُقارْنَة	N	comparison
حَلال	ADJ	honest
مِحَوِّش	ADJ	saving
كِفايَة	N	sufficiency
نِعْم	N	wonderful
مَصْرُوف	N	expenditure
دَوَّخ	V	conquer
سِيب	V	give_up
حِقْد	N	malice
قُدّام	N	front
خَلَّص	V	purify
بُكْرَة	N	tomorrow
سَهِّل	V	make_easy
حَوِّش	V	save
جَوِّز	V	marry
تَحْوِيشَة	N	savings
مُسَمَّى	N	title
عِبْرِيَّة	N	Hebrew_(language)
مَعْرُوف	ADJ	known
ضَمّ	V	include
تَشْوِيش	N	disturbance
تَزْوِير	N	forgery
لَوي	N	bending
مِصْداقِيَّة	N	credibility
مَأْخَذ	N	source
مُتَوَقَّع	ADJ	expected
عُدْوان	N	aggression
غَرْبِي	ADJ	west
كَلْب	N	dog
سِيد	N	master
ماشِي	ADJ	going
أُونكِل	N	uncle
كِتِر	V	exceed
أَصْبَح	V	become
سِلْعَة	N	commodity
مِتشاف	ADJ	seen
وَرا	N	behind
قَدَر	V	be_able_to
وَكِيل	N	representative
تَثْقِيف	N	education
تَهْذِيب	N	refinement
اِعْتَرَض	V	be_inserted_in
قَرَأ	V	read
وُجُود	N	presence
عَمَل	N	work
نَوع	N	type
اَساسِي	ADJ	fundamental
أَوَّلِي	ADJ	first
جانِب	N	side
سُلُوك	N	behavior
سِياسِيّ	ADJ	political
عَقُول	N	camel_thorn
ثالِث	ADJ	third
واسِع	ADJ	wide
هامّ	ADJ	important
اَداة	N	Gloss
مِلاحْقَة	N	persecution
تَطَوُّر	N	progress
اُسْلُوب	N	method
تَقْدِيم	N	offering
صُحُفِيّ	ADJ	journalistic
مِتابِع	ADJ	following
حَدِيث	ADJ	new
أَمانَة	N	faithfulness
ذَكَر	V	mention
نِسِي	V	forget
حَبْس	N	confinement
تَحْت	N	under
تَعْبِير	N	expression
طَبَع	V	print
مُصادَر	ADJ	confiscated
جَرِيدَة	N	newspaper
ثَرْوَة	N	wealth
دِفاع	N	defense
فِضِيحَة	N	disgrace
فَوْق	N	above
مَلْيان	ADJ	Gloss
تانِي	N	others
عائِلَة	N	family
شَمْس	N	sun
شاف	ADJ	Gloss
أَبْرِيل	N	April
عامْلَة	ADJ	Gloss
حِدَة	N	separately
عَبَّر	V	express
خُصُوص	N	matter
حِبْر	N	ink
مُعارْضَة	N	opposition
غَضَب	N	anger
اِتْحَرَّك	V	get_moving
سِلْمِيّ	ADJ	peaceful
اِختَلَف	V	disagree
مَضْمُون	ADJ	guaranteed
تاب	V	repent
تَأْثِير	N	effect
اِيقاف	N	stopping
مُجْتَمَع	N	society
تَحْرِيك	N	making_move
وَعْي	N	consciousness
شَكَر	V	thank
اِتاحَة	N	granting
فُرْصَة	N	opportunity
تَبادُل	N	exchange
حَمْلَة	N	campaign
سِكِن	V	dwell
طَعام	N	food
فُلان	N	so-and-so
جُوع	N	hunger
دَلالَة	N	meaning
شِدَّة	N	intensity
شَفَق	V	pity
بَوِّس	V	kiss
لاقِي	ADJ	finding
قُمامَة	N	rubbish
مُخَلَّف	N	leftover
مَطْعَم	N	restaurant
مُنْتَهِي	ADJ	finished
سِعْر	N	price
قَلّ	V	be_less
فِئَة	N	faction
اِطْعام	N	feeding
لَزَم	V	required
تَبَعِيَّة	N	subordination
قَضَى	V	execute
نِصْف	N	halves
عَجِيب	ADJ	astonishing
خَلْطَة	N	mixture
دِقِيق	N	flower
مِدَعَّم	ADJ	Gloss
حَدِيدِيّ	ADJ	iron
فَتْفُوتَة	N	crumb
كِفاح	N	struggle
مُسْتَمِيت	ADJ	death-defying
بَلَغ	V	reach
قَسْوَة	N	harshness
جَحِيم	N	hell
شَبَع	V	have_enough
اِجْتَمَع	V	gather
هِجْرَة	N	emigration
راقِي	ADJ	ascending
سَكَن	V	be_calm
خَنْشُور	ADJ	Gloss
اِزْداد	V	increase
مَخاطِر	N	dangers
عُبُور	N	crossing
شاطِئ	N	shore
يَقِين	N	certainty
حَيّ	N	creature
وَفِير	ADJ	ample
شَجَرَة	N	tree
قِطْعَة	N	piece
خَشَبِيّ	ADJ	wooden
مَرْكِب	N	ships
صَيّاد	N	hunter
دام	V	last
جاد	V	improve
آخَر	ADJ	other
جَمّ	N	ample
مِهاجْرَة	N	Gloss
تَزاحُم	N	competition
سَقَط	V	fall
يَمّ	N	direction
ماء	N	water
جَزْر	N	slaughter
خَشَب	N	wood
غِرِق	V	drown
تَعَب	N	disturbance
شِدِيد	ADJ	strong
مُمِيت	ADJ	fatal
اِنْطَلَق	V	get_started
بَحَث	V	discuss
واقِعَة	N	incident
عاد	V	return
قَدَم	N	foot
رابِع	ADJ	fourth
فُمّ	N	mouth
قُطَّة	N	cats
شَرِس	ADJ	vicious
باب	N	door
ذَهَبِيّ	ADJ	golden
بارِد	ADJ	cold
حامِي	ADJ	heated
لاصِق	ADJ	adhesive
سامّ	ADJ	poisonous
تَقْلِيدِيّ	ADJ	traditional
وَرْدَة	N	flower
فَرّ	V	escape
سابِل	N	public_road
مُتَشَرِّد	ADJ	homeless
قِطَّة	N	female_cat
مُتَوَحِّش	ADJ	savage
قِشْرَة	N	dandruff
مَأْساة	N	tragedy
ظابِط	N	officers
مُحْتَرَم	N	esteemed
خُلُق	N	ethics
تَقْوَى	N	piety
دِيَّة	N	blood_money
سَوْداوِيّ	ADJ	melancholic
طالِب	N	student
ثانَوِيّ	ADJ	secondary
شُعْبَة	N	branch
تَدْمِير	N	destruction
تَعْلِيمِي	ADJ	instructional
مَرْمُوق	ADJ	highly-regarded
كافَّة	N	all
مَجال	N	area
مُسْتَقْبَل	N	future
دِراسَة	N	study
كَشَف	V	discover
طالِبَة	N	Gloss
مُتَّحِد	ADJ	united
نُبُوغ	N	emergence
جُلُوس	N	sitting
طِبّ	N	medicine
مِتْقَدِّم	ADJ	developed
بَحْث	N	discussion
طِبِّيّ	ADJ	medical
رَحِيل	N	departure
رَغْبَة	N	desire
عِلْمِيّ	ADJ	scientific
دَقِيق	ADJ	precise
ثانَوِيَّة	N	Gloss
جامِعِيّ	ADJ	university
فاشِل	ADJ	failing
باظ	V	decompose
مَنارَة	N	beacon
حَضارَة	N	civilization
مُتَفَوِّق	ADJ	superior
اِسْتِعْداد	N	preparation
طالِب	N	student
اِتْعَلِّم	V	study
ذاكِر	V	review
اِمْتِحان	N	exam
نَسَى	V	forget
مُدَرَّج	N	amphitheater
دُكْتَور	N	doctor
شَرَح	V	explain
مِتْخَرَّج	ADJ	graduate
لازْمَة	N	need
اِجْتِماع	N	gathering
بَيْن	N	Gloss
تَنْدِيد	N	criticism
كَفَى	V	be_enough
مَرّ	N	passing
صَبْر	N	patience
اِنْعِقاد	N	convening
قِمَّة	N	summit
صار	V	become
شَبَه	V	liken
اِقْتِراح	N	suggestion
مُتَوَقِّع	ADJ	expecting
ضَرُورَة	N	necessity
رَغَع	V	Gloss
قَطِيعَة	N	breaking
كِذْبَة	N	lie
مُوَحَّد	ADJ	united
اِتِّفاقِيَّة	N	accord
حِلْم	N	benevolence
خارِجِي	ADJ	outside
مادَّة	N	substance
تَوقِيع	N	signing
مُعاهْدَة	N	treaty
جامِعَة	N	university
عُضْو	N	member
اِرادَة	N	desire
مَقْبُول	N	accepted
حُكْم	N	judgment
تارِيخِي	ADJ	historical
حَكَم	V	judge
سُؤال	N	question
اِجابَة	N	answer
اِسْتِهْزاء	N	ridicule
إِنْشاء	N	establishing
اِهْتِمام	N	attention
كَيفِيَّة	N	manner
تَطْبِيق	N	application
اِخْتَصَر	V	summarize
تَشْكِيل	N	formation
دَولِي	ADJ	universal
اَرَى	V	see
ثَبَت	V	be_stable
عَكْس	N	opposite
حِكْمَة	N	wisdom
تالِي	ADJ	following
تَطْبِيع	N	normalization
مُبْتَذَل	N	vulgar
ضِحْك	N	Gloss
زار	V	visit
مُسْتَحِيل	N	impossibility
تَأْشِيرَة	N	Gloss
مِوافِق	N	agreement
هِنا	N	Gloss
ئِستَطاع	V	be_capable_of
هَيَّأ	V	mobilize
صُلْح	N	peace
خَيِّر	ADJ	good
مُحاوْلَة	N	attempts
شَقِيق	N	brother
مُبادْرَة	N	proposal
اَكْثَر	N	Gloss
مُحَصِّلَة	N	Gloss
جَلَس	V	sit
مُطْلَق	ADJ	absolute
خاطِر	N	mind
حَلِيب	N	milk
قِشْطَة	N	cream
بِتْرَول	N	oil
مِعايْرَة	N	calibration
اِكْتِشاف	N	discovery
أُكْتَوبَر	N	Gloss
مَنْع	N	prevention
اِرْتِفاع	N	height
وِصِل	V	arrive_at
اِضْعاف	N	weakening
اِحْتِقان	N	flush
مُنْضَمّ	ADJ	affiliated
مُمْتَدّ	ADJ	stretching
جِوار	N	near
أَمْن	N	security
جَنُوب	N	south
سابِق	ADJ	former
اِتَّصَل	V	contact
نَبَأ	N	news_item
اِخْتَفَى	V	disappear
غامِض	ADJ	obscure
مُباشِر	ADJ	direct
صَرِيح	ADJ	candid
اِسْتِغْلال	N	exploitation
اِنْتِفاع	N	use
شَجاعَة	N	courage
قاع	N	bottom
شَرْعِي	ADJ	legislative
وِراثَة	N	inheritance
باطِل	ADJ	void
فاقِد	ADJ	deprived_of
حادِث	N	incident
اِسْتَقْبِل	V	receive
تَرَك	V	leave
اِسْتَهْزَأ	V	Gloss
جُمْلَة	N	sentence
اِتْحَكَم	V	be_judged
مُراد	N	object
طَرْح	N	suggestion
تَفْكِيك	N	dismantling
وَضْع	N	laying_down
حاجَة	N	need
مَنْقُول	ADJ	conveyed
زَبّال	N	garbage_collector
كَسَف	V	be_gloomy
قَبِيلَة	N	tribe
أَورَث	V	transmit
لَيْسَ	V	not_be
رُجُولَة	N	masculinity
سَهْل	ADJ	easy
عَوْلَمَة	N	globalization
تَجَمُّع	N	gathering
زِيّ	N	uniform
كاذِب	ADJ	false
ناعِم	ADJ	smooth
عِدَّة	ADJ	several
فارِغ	ADJ	empty
وَضَع	V	put
كاسَة	N	cup
قَلَب	V	turn_around
شِرِيط	N	tape
مَبْسُوط	ADJ	cheerful
مِفَسَّر	ADJ	commentator
سَعادَة	N	happiness
عَقْل	N	mind
اَخِير	N	Gloss
خايِف	ADJ	frightened
غَلَط	N	error
فَرْفَشَة	N	Gloss
رَفاهِيَّة	N	comfort
دَعَى	V	call_someone_names
مِقاوْحَة	N	debate
أَوَّل	N	first
فَكْهَة	N	fruit
خِيارَة	N	cuccumber
دِنْيا	N	world
جَيب	N	pocket
جِيب	N	jeep
غَلا	V	exceed
غِيرَة	N	jealousy
مَعْدِنِيّ	ADJ	mineral
زِير	N	earthenware
تَطْهِير	N	purging
شُرْب	N	drinking
اِعْطاء	N	offer
شَكّ	N	doubt
تَنْقِيَة	N	purification
زايِد	ADJ	exceeding
اِرْتَفَع	V	rise
تَكْلِفَة	N	cost_computation
تُجارِي	ADJ	business
مَلابِس	N	dress
شَهْرِيّ	ADJ	monthly
عِمارَة	N	building
مَشْغُول	ADJ	busy
مِيَّة	N	hundred
مُواصْلَة	N	continuation
قَد	N	may
زِحام	N	crowded
اِخْتِناق	N	constriction
بَنْزِين	N	fuel_tank
حَوالِي	N	Gloss
ضَعْف	N	impotence
مَشَى	V	walk
مَشْي	N	going
صِحَّة	N	health
عِلاج	N	treatment
كَثِير	ADJ	many
غَلِّت	V	be_made_weedy
مِتْرُو	N	metro
نَفَق	N	tunnel
غَلاسَة	N	obnoxiousness
رِكِب	V	climbe
تَكَدُّس	N	accumulation
بَطَل	N	hero
رِياضِي	ADJ	sportive
مَشَّى	V	make_walk
قَطْم	N	cutting_off
رَقَبَة	N	neck
مَسْتُور	ADJ	hidden
أَثَّر	V	affect
وَد	V	like
شَكْوَى	N	complaint
مِجاوْرَة	N	neighborhood
عَدَد	N	number
تَعْداد	N	counting
مَدِينَة	N	city
رَبّ	V	be_master_of
مَعِيشَة	N	livelihood
تَغْذِيَة	N	feeding
دِيانَة	N	religion
عَبْدَة	N	Gloss
دِرِي	V	Gloss
مُلْقَى	ADJ	discarded
جُنُون	N	madness
مُصارْعَة	N	wrestling
اُغْنِيَّة	N	lyrical_song
ناقِش	V	discuss
مَخْرُوم	ADJ	defective
فايْدَة	N	benefit
صَنْعَة	N	craft
اِشتَكَى	V	complain
بَنَى	V	build
غُرْزَة	N	stitch
مَقْهَى	N	caf
زالِف	ADJ	Gloss
غَدا	N	tomorrow
نَصِيب	N	share
قَنْزَحَة	N	arrogance
أَقْرَع	ADJ	bald
نُزَهِي	ADJ	excessive
لُقْمَة	N	morsel
غُمُوس	N	eating_of_fod
حَلَّى	V	sweeten
شاي	N	tea
طاسَة	N	large_metal_serving_bowl
دَوَّر	V	rotate
خَبَط	V	beat
جَعَل	V	make
عامِر	ADJ	flourishing
مِفَيِّش	N	Gloss
أَمَل	N	hope
وَرَّى	V	stoke
فَلَح	V	cultivate
نَمْرُود	ADJ	ungrateful
عان	V	assist
صَدْمَة	N	shock
نَجاح	N	success
اِقْناع	N	persuasion
تَكْيِيف	N	conditioning
عَلّاقَة	N	clothes_hook
خِلافَة	N	succession
أَكْلَة	N	meal
دَعْم	N	support
اِشْتِراك	N	partnership
مَصْيَف	N	summer_resort
خَبْز	N	Gloss
مُدَعَّم	ADJ	strengthened
لَمَس	V	touch
ناصِح	ADJ	advising
لِحِق	V	follow
هَبْشَة	N	grip
حَوِّل	V	convert
بَنْك	N	bank
سِوِيسرِي	ADJ	swiss
سَبُّوبَة	N	business
كِيلُو	N	kilo
مُفِيد	ADJ	useful
فِسِيخَة	N	fish
شَراب	N	beverage
هَرَم	N	senility
نَصّاب	N	swindler
مَنْصُوب	ADJ	erected
خَرِيطَة	N	map
سابِع	ADJ	seventh
أَعَدّ	V	prepare
اِتِّصال	N	communication
اِحْتِجاج	N	protest
اِسْتِيضاح	N	request_for_clarification
بَيان	N	communiqu
مَذْكُور	ADJ	mentioned
مُرْتَبِط	ADJ	connected
مُرُور	N	going_(through)
اِدارَة	N	administration
ضَجَّة	N	noise
أَبِيب	N	Aviv
أَضاف	V	add
مِشاكِل	N	Gloss
مُعْتَرِف	ADJ	Gloss
لِعْب	N	Gloss
عَلَّق	V	comment
مُهِمَّة	ADJ	Gloss
بِعِيد	ADJ	remote
تَمام	N	exact
غِضِب	V	ger_angry
بَوّ	N	Gloss
زَمَلْكاوِي	ADJ	zamalkawy
خَضار	N	greenery
حَيط	N	wall
رَدَّة	N	reverberation
كِدَه	ADJ	Gloss
اِنْتاج	N	output
بَيعَة	N	homage
رُبْع	N	quarter
حَقِيقِي	ADJ	right
حَطّ	V	descend
سِفارَة	N	embassy
حَرْق	N	burning
مَرْكَز	N	center
تَمْيِيز	N	distinction
شَدِّد	V	strengthen
مِنازِل	N	adversary
مِخالِف	ADJ	divergent
قانُون	N	law
قَدَر	N	fate
حُرِيَّة	N	freedom
طالِب	V	look_for
اِتْعامِل	V	behave
مِجْتِمِع	N	Gloss
واجِب	N	duty
مُضِيف	ADJ	adding
آَمِن	ADJ	secure
أَصْدَر	V	issue
اِقامَة	N	residency
فَرْض	N	imposing
عادِل	ADJ	fair
أَيض	N	metabolism
مادِّيّ	ADJ	material
رِعايَة	N	custody
تَحْرِيض	N	incitement
عُنْف	N	violence
عِبادَة	N	worship
مَقْصُود	ADJ	deliberate
أَخ	N	brother
خانَة	N	compartment
مُمارْسَة	N	practice
مُنْطَلَق	N	premise
طائِفِيَّة	N	sectarianism
أَمْثَل	ADJ	exemplary
نِقاش	N	debate
تَصْحِيح	N	correction
سَلْبِيّ	ADJ	negative
بَلْبَلَة	N	confusion
مُخْتَلِف	N	different
حَسْم	N	settlement
تَلْك	N	Gloss
اِتْكَرَّر	V	be_repeated
زائِر	N	visitor
رابِط	N	tying
فَجْأَة	N	suddenly
غَلْطَة	N	error
اِسْتَنَّى	V	wait
لَوِّش	V	control
كَرَّم	V	venerate
آَجِر	V	lend
تَوبَة	N	repentance
قِتال	N	fighting
سَحَرَة	N	witch
أَدْخَل	V	enter
سَجْدَة	N	prostration
مِتْمَدِّن	N	civilized
تَوْعِيَة	N	making_aware
خَلَّع	V	remove
اِجْرامِي	ADJ	criminal
بَقَرَة	N	cow
عَقِيدَة	N	doctrine
اِسْتِحالَة	N	absurdity
اِسْتَغَلّ	V	take_afvantage
اَوِّل	N	Gloss
أَدام	N	perpetuate
كامِن	ADJ	hidden
أُوتُوبِيس	N	bus
مُسْتَقِلّ	ADJ	independent
تَنَقُّل	N	transportation
نِتّ	N	immediately
اِتَّضَح	V	become_clear
فاحِش	ADJ	monstrous
سَبَب	N	reason
عُرْفِيّ	ADJ	conventional
طَرْقَة	N	knock
سَحْل	N	Gloss
عِلاقَة	N	relationships
نَدِيّ	ADJ	moist
خاف	V	fear
بَطْش	N	force
اِتِّجاه	N	direction
بِيئَة	N	environment
مُسْتَعِدّ	ADJ	ready
تَفْكِير	N	thinking
رَدْع	N	deterrence
تَصَوُّر	N	depiction
عَصايَة	N	stick
اِستَنَد	V	rely
تُراث	N	heritage
راسِخ	ADJ	firmly_established
مِسْتَخَبِّي	ADJ	hiding
مَحْكُوم	N	governed
مَنْطِق	N	logic
مَزاج	N	taste
صَبَح	V	become
اِمْرَأَة	N	woman
داخِل	N	inside_of
قاعِدَة	N	base
هَتَك	V	rip_apart
داس	V	step_on
عادِيّ	ADJ	ordinary
طَبِيعَة	N	nature
بَدا	V	appear
أَنْكَر	V	deny
مُسْتَحِيل	ADJ	impossible
مَمْلُوك	ADJ	owned
اِسْتِطاعَة	N	capability
جاهِل	ADJ	ignorant
مَفْتُوح	ADJ	open
مِقَيِّد	ADJ	Gloss
تَداوُل	N	alternation
دَعْوَى	N	lawsuit
اِتْذَكَّر	V	remember
فَضِيحَة	N	scandal
صاحْبَة	N	friend
مُحاكَمَة	N	judicial_proceeding
مُنْبَطِح	N	prostrate
تَصَنُّت	N	Gloss
مُنافِس	ADJ	competing
بال	V	urinate
اِستَغَلّ	V	take_afvantage
حِساب	N	calculation
حاسِب	V	punish
مُحاسْبَة	N	accounting
فُجُور	N	immorality
اِمتَدّ	V	go
اِسْتِبْداد	N	despotism
حُبْلَى	N	pregnant
سَمَّع	V	make_hear
عَلامَة	N	mark
مِشّ	N	whey
دُودَة	N	Gloss
بَلّاص	N	jar
هَزّ	V	shake
كِتْف	N	buttress
عِبارَة	N	expression
ساحَة	N	scene
سَرِيع	ADJ	quick
مِجَمِّد	ADJ	freezing_compartment_in_a_refrigerator
خِلاف	N	dispute
داخِلِيّ	ADJ	internal
كَم	N	quantity
كِيف	N	how
مُقَيَّد	ADJ	bound
سِوَى	N	other_than
بَدْلَة	N	suit
اِكْمال	N	Gloss
مُتاح	ADJ	provided
سِرّ	N	secret
تَلْمِيع	N	polishing
عاتِق	N	shoulder
ذاتِيّ	ADJ	autonomous
مُضْحِك	ADJ	laughable
كانِي	N	Gloss
هابِط	ADJ	landing
اِعْتِراض	N	resistance
صُراخ	N	shouting
مُعارَضَة	N	opposition
اِسْتِحْسان	N	approval
تَصْفِيق	N	applause
رَنِين	N	ringing
شائِك	ADJ	barbed
مِعارِض	ADJ	opposing
أَخَذ	V	take
مُؤَدَّب	ADJ	well-bred
اِطْلاق	N	releasing
حِلّ	N	free
شَعْرَة	N	hair
مُحِقّ	ADJ	justified
وِسْط	N	center
مِعَلِّم	ADJ	teacher
عَدِيم	ADJ	without
أَيّ	N	any
حَثّ	V	encourage
دَسّ	V	insert
سِمّ	N	poison
تَحَفُّظ	N	caution
فَعّال	ADJ	effective
اِنتَمَى	V	belong
مُوَفَّق	ADJ	successful
رِياسَة	N	leadership
جُمْهُورِيَّة	N	republic
مُقْتَنِع	ADJ	satisfied
جَمْعِيَّة	N	association
أَسِّس	V	found
حُمار	N	donkey
مُقابِل	N	in_exchange_for
صَدِيق	N	friend
حَدِيقَة	N	garden
حَيَوان	N	animal
مَحْجُوز	ADJ	Gloss
مِصَمِّم	ADJ	designer
تِعْبان	N	snake
ذِمَّة	N	protection
فال	N	omen
وَثَنِيّ	ADJ	pagan
دِيمُقْراطِي	ADJ	democratic
لُزُوم	N	requirement
شامِل	ADJ	comprehensive
أَدْرَج	V	insert
قُوَّة	N	power
تَحْوِيل	N	conversion
تَنْمَوِيّ	ADJ	developmental
ظِلّ	N	patronage
اِقْتِصادِيّ	ADJ	economic
تَغَلُّب	N	surmounting
اِعْلان	N	declaration
مالِص	ADJ	Gloss
ضَمَن	V	gurantee
تَخْرِيج	N	upbringing
بَدَل	N	substitute
واقِف	ADJ	standing
بَرْدَعَة	N	saddle_cloth
مَجْهُود	N	efforts
هايِل	ADJ	wonderful!
نَقَل	V	transfer
حِلْف	N	treaty
رَئِيسِي	ADJ	main
اِخْضاع	N	subjection
نَوَوِي	ADJ	atomic
نَزْع	N	removal
اِيجاد	N	discovery
مُهَلَّبِيَّة	N	mahallabiya_(rice_pudding_topped_with_pistachios)
عَدْل	N	justice
هَزِيل	ADJ	emaciated
جَسِيم	ADJ	great
هَوان	N	insignificance
مُرَكَّز	ADJ	concentrated
مُتَداخِل	ADJ	conflicting
لَوعَة	N	anguish
فادِح	ADJ	burdensome
حَرِير	N	silk
ثَوْرِيّ	ADJ	revolutionary
تَقْلِيَة	N	alkalization
سَجَن	V	imprison
غَرَق	N	drowning
هُرُوب	N	escape
مُطالِب	ADJ	demanding
قِصاص	N	reprisal
هارِب	ADJ	fugitive
سَجْن	N	detention
جَدِير	ADJ	worthy
صارِخ	ADJ	loud
شَغَل	V	occupy
آَتِي	ADJ	following
قَتِيل	N	casualty
مَجّان	N	free
زَحْمَة	N	crowded
شُوَيَّة	N	few
جَزْمَة	N	shoes
عَوَّض	V	replace
رِخِص	V	be_tender
طِنّ	N	ton
فَرْقَعَة	N	crack
صادِر	ADJ	issued
بَحْثِيّ	ADJ	research
مُخِيف	ADJ	frightful
بُوصلَة	N	compass
دائِرَة	N	office
عَمالَة	N	labor_force
اِسْرائِيلِي	ADJ	israeli
أَجْنَبِي	ADJ	foreign
اِجْمالِي	N	Gloss
أَنْجَب	V	give_birth
سَبْع	N	lion
أَقام	V	install
أَوضَح	V	clarify
جِنْسِيَّة	N	nationality
كِدِب	V	lie
نَصَّب	V	install
سَعَد	V	make_someone_happy
مَصْنَع	N	factory
لَقَى	V	find
اِستاهِل	V	deserve
نَتَج	V	result_(in)
مُتَكَرِّر	ADJ	repeated
عَفْو	N	pardon
سُخْرَة	N	target_of_ridicule
قَد	ADJ	Gloss
آَيَة	N	Quranic_verse
خاض	V	wage
تَفْصِيل	N	detailing
ناحْيَة	N	Gloss
تارِيخِيّ	ADJ	historical
رَجا	V	request
تَقْلِيل	N	decrease
تَسْيِير	N	propulsion
تَرْدِيد	N	repetition
رَدِّد	V	repeat
رَفَض	V	reject
مُثَقَّف	ADJ	intellectual
صادِق	ADJ	veracious
خِرِّيج	N	graduate
حَفَظ	V	preserve
مَكْرُوه	N	accident
مَبْدَئِيّ	ADJ	fundamental
اِخْتِلاف	N	variance
أَثْبَت	V	ascertain
كامِل	N	entire
خاصَّة	ADJ	elite
أَوسَط	ADJ	Gloss
شَرَّف	V	honor
بَعْد	N	after
دَعَّم	V	support
مُقِيم	ADJ	residing
رافِض	ADJ	rejecting
دِرْع	N	armor
سَبِيل	N	way
نَصْر	N	victory
كَفِيل	N	responsible
حالِي	ADJ	current
قُرَيِّب	N	Gloss
تالِي	N	therefore
صِلَة	N	link
مُسْتَغْرِب	ADJ	finding_strange
قَبَض	V	arrest
شَتَم	V	revile
مُكافئَة	N	reward
عَمّال	ADJ	continue
شَنِيع	ADJ	hideous
بَطّال	ADJ	idle
حَيّا	V	praise
أَصِيل	ADJ	authentic
مُنَسِّق	ADJ	coordinating
لِيبِيّ	ADJ	Libyan
اُسْبُوع	N	week
مَساء	N	evening
ضَيف	N	guest
تَهَكُّم	N	scorn
سُخْرِيَّة	N	sarcasm
عَجَب	N	admiration
فِكْر	N	thought
داعِي	N	cause
تَفْوِيض	N	authorization
جُمْهُورِيّ	N	republican
مُسَلَّح	ADJ	armored
عاقِل	ADJ	rational
مَجْنُون	ADJ	crazy
نِطاق	N	scope
جاز	V	be_allowed
قاصِر	ADJ	limited
ذَكاء	N	intelligence
أَب	N	father
نَدَم	N	remorse
خَفِيّ	ADJ	hidden
اِسْكان	N	housing
نَزَل	V	descend
واصِل	ADJ	coming
دايْم	ADJ	eternal
تَصْوِيت	N	voting
مِشَرَّح	N	anatomist
بَلْطَجِي	N	ruffian
اِسْتَعان	V	seek_assistance
فاز	V	win
عافْيَة	N	Gloss
مُحافِظ	N	governor
تَحْرِير	N	liberation
خَلَص	V	conclude
اَوِّي	ADJ	very
دايْماً	N	Gloss
شَدّ	V	make_tight
قَطَّع	V	cut_apart
خُلُص	V	finish
نَهاردَة	N	this_day
كُلِّيَّة	N	faculty
زِمِيل	N	companion
ضَحْكَة	N	laugh
بَشُوش	ADJ	smiling
دُكْتُور	N	doctor
حِزِن	V	grieve
مُهاجِر	N	emigrant
مِعَدِّي	ADJ	Gloss
تَهْلُكَة	N	ruin
اِغْراء	N	incitement
عَيلَة	N	family
مُصاب	ADJ	afflicted
رافِع	ADJ	lifting
راس	N	top
زَوجَة	N	wife
يَهُودِيّ	N	Jew
سِكِّينَة	N	knife
سَمْن	N	cooking_butter
وَعْكَة	N	indisposition
مِئَزِّم	ADJ	making_worse
ذَلّ	V	humiliate
حَصَّل	V	be_obtained
مَسِيحِيّ	N	Christian
مُوافِق	ADJ	agreeing
هاجِر	V	be_distant
عِقاب	N	punishment
هِدايَة	N	guidance
مِتخَيِّل	ADJ	imagining
ضَحَّى	V	sacrifice
مُنْتَشِر	ADJ	spreading
بَقا	V	be
مُمْتاز	ADJ	excellent
اِسرائِلِيّ	N	jew
عَوَطَلجِيّ	N	jobless
زِبالَة	N	any_discarded_articles
فاجِر	ADJ	immoral
جَوَّع	V	make_starve
أَولَوِيَّة	N	priority
آسِف	N	sorry
تَطْوِيل	N	lengthening
مَجّانِيّ	ADJ	free
شَهْرِي	ADJ	monthly
حَدِيث	N	discussion
اِمْكانِيَّة	N	possibility
عَقارِي	ADJ	real_estate
اِضافَة	N	Gloss
طَلاق	N	divorce
مُفْلِس	ADJ	bankrupt
مُتَرَدِّي	ADJ	deteriorating
اِسْتِمْرار	N	continuousness
اَجْنَبِيَّة	N	Gloss
واجِه	V	confront
حالِيّ	ADJ	present
ظاهِرَة	N	phenomenon
عُنُوسَة	N	celibacy
مِكاتِب	N	correspondent
سَمْسَرَة	N	brokerage
بَخْت	N	luck
خِداع	N	deception
مَكْسَب	N	gain
مِحَيَّر	ADJ	worrying
يُمْن	N	good_fortune
فات	V	expire
جايِز	ADJ	lawful
كَذا	ADJ	Gloss
راحَة	N	rest
شاغِل	ADJ	working
اِتْبَعَت	V	send
مِطالْبَة	N	Gloss
صَفْحَة	N	page
مُعْظَم	N	majority
عَبِيط	ADJ	fool
غاظ	V	enrage
دَيل	N	jar
قُطّ	N	male_cat
قَفا	N	backs
راكِب	ADJ	riding
عَجَلَة	N	hurry
اِسْتِفْزاز	N	incitement
اِشْتَرَك	V	participate
مُعْجَب	ADJ	admirer
مُشْتَرِك	N	participant
نَبِي	N	prophet
مَرِير	ADJ	stubborn
مِترَكِّب	ADJ	composed
نَصَح	V	advise
رَدّ	N	reply
أَلْعَن	ADJ	most_wicked
عَجْن	N	kneading
صَغِير	ADJ	small
إِعْطاء	N	offer
مُقْنِع	ADJ	convincing
قُصاد	N	in_front_of
غَلَط	ADJ	wrong
مِقَصَّر	ADJ	negligent
واحْدَة	N	Gloss
لايِك	N	Gloss
داخِل	ADJ	entering
مَجْمُوعَة	N	collection
خَبَّط	V	hit
حَيطَة	N	caution
خِلِي	V	let
جِيم	N	jim_(Arabic_letter)
سامِح	V	treat_kindly
تَعْمِيم	N	generalization
مارِس	N	March
دُسْتُورِيّ	ADJ	constitutional
مُعْتَرِض	ADJ	opposed
اِنْتِقالِي	ADJ	transitional
مُحْتار	ADJ	confused
مُتَكامِل	ADJ	perfect
تَنَحِّي	N	withdrawal
تَوَلِّي	N	taking_charge_of
زِمام	N	reins
صَوَّت	V	vote
بِطاقَة	N	card
مِتْجَوِّز	ADJ	Gloss
سِقِط	V	fall
سُقُوط	N	fall
فَيِّش	V	Gloss
اِسْتَقَرّ	V	settle_down
مُسْتَقِرّ	ADJ	stable
اِعْتِصام	N	preservation
اِسْتِفْتاء	N	questionnaires
مِعَدِّلَة	ADJ	Gloss
مِتِّفِق	ADJ	in_agreement
مُنْتَظِر	ADJ	waiting
سَوا	N	together
دِبْلُوماسِي	ADJ	diplomatic
خَلِّف	V	have_children
اُوتُوماتِيك	ADJ	automatic
مِرات	N	wife
أَقْنَع	V	persuade
حابّ	ADJ	liking
واقِعِيّ	ADJ	realistic
اِتْقَبَل	V	accept
حِيرَة	N	confusion
اِخْتَلَف	V	disagree
مَوقِف	N	position
بَلَدِي	ADJ	indigenous
مُرَكِّز	ADJ	focusing
حاب	ADJ	loving
اِلْتِحاق	N	entering
شَعْبِي	ADJ	popular
اِنْتِهاء	N	finishing
خايِف	N	afraid
مُنَوَّر	ADJ	shining
مِيدان	N	square
نَتِيجَة	N	result
حَرَكَة	N	movement
نِضِيف	ADJ	clean
مُتَوَسِّط	ADJ	middle
مِوافِق	ADJ	agreeing
مُسْتَشار	N	counselor
أَتَي	V	come
جَمال	N	beauty
عَيِّل	ADJ	dependent
عامِل	V	treat
مُقَدَّس	ADJ	holy
تَخْوِيف	N	intimidation
واقِعِي	ADJ	realistic
مَجْمُوع	N	total
مُرْضِي	ADJ	satisfactory
مُحْبَط	ADJ	Gloss
مُداخَلَة	N	interference
عَذْب	ADJ	sweet
فَرَض	V	impose
تَشْرِيع	N	legislation
دِيمُقراطِيَّة	N	democracy
بارَك	V	bless
وَضَح	V	become_clear
اِخْتِبار	N	testing
اِسْتَوقَف	V	catch
ذاتِي	ADJ	autonomous
مِتْأَثَّر	ADJ	because_of
جِهْد	N	exertion
قَرار	N	decision
الآخَرَر	ADJ	other
اِقْتَنَع	V	be_convinced
مُؤَيِّد	ADJ	supporting
كِتابَة	N	writing
مُلاحْظَة	N	observation
هَوهَو	V	bark
صِيغَة	N	form
كُوتَة	N	Gloss
نُصّ	N	halves
نازِل	ADJ	staying
بُرْصَة	N	stock_exchange
حَوض	N	basin
مُصِيبَة	N	accident
مُتَدَهْوِر	ADJ	deteriorating
مُلْزِم	ADJ	binding
مِحْتاج	N	in_need
اِيجابِي	ADJ	positive
حِمايَة	N	protection
مِسْتَحْمِل	ADJ	standing
اِحالَة	N	transfer
تَظاهُرَة	N	rally
مِليُونِي	ADJ	million
خَطِير	ADJ	serious
وِحْدَة	N	units
طائِفِيّ	ADJ	sectarian
شِهِد	V	witness
نُزُول	N	descent
تَعْطِيل	N	hindering
مُراسِل	N	correspondent
اِعادَة	N	return
كِنِيسَة	N	churches
تَخْرِيب	N	destruction
مُظاهْرَة	N	demonstration
اِصْدار	N	export
اِعْتِقال	N	detention
اِشْتِباه	N	suspicion
مُتَظاهِر	N	demonstrator
اِحْتِجاز	N	confiscation
شاعِر	ADJ	feeling
ذَخِيرَة	N	ammunition
حَيّ	ADJ	alive
يَنايِر	N	January
أَطْلَق	V	release
ضَخْم	ADJ	large
بَلْطَجِيّ	ADJ	gangster
اَلف	N	thousands
شَبِيه	ADJ	resembling
اِعْدام	N	execution
قَعْدَة	N	sitting_place
مُنْفَعِل	ADJ	agitated
اِنْفِعال	N	emotion
اَفَنْدِم	N	afandem
وُرُود	N	appearance
فَرْد	N	individual
مِسامِح	N	pitiful
غادِر	ADJ	perfidious
رَأْس	N	head
مُصَفَّح	ADJ	ironclad
مَطّاطِيّ	ADJ	rubber
مَلَيان	N	filling
مُسِيل	ADJ	making_flow_(tear_gas)
شَظِيَّة	N	splinter
اِنْهال	V	precipitate
هَتَف	V	call
عِباد	N	mankind
مَرْمَط	V	damage
اِنْفَعَل	V	get_angry
طالَب	V	demand
مُعافَى	ADJ	exempted
تَلْبِيَة	N	compliance_with
مَقَرّ	N	center
شَوّايَة	N	grill
خَلْفِي	ADJ	rear
رَمَى	V	throw
زِنْزانَة	N	prison_cell
عَصا	N	stick
صَرَّخ	V	shout
سِرِّيّ	ADJ	secret
قِسِم	V	divide
هاتِف	N	telephone
قَهْر	N	subjugation
كَفاءَة	N	competence
مُخْبِر	N	informer
واطِي	ADJ	low
غَرَّق	V	submerge
مُتَهالِك	N	exhausted
مَسنُود	ADJ	supported
ضَيَّق	ADJ	make_narrow
حَقِير	ADJ	despised
شَحَت	V	ask_for_alms
عالِج	V	be_healed
فَخَر	V	be_proud
صَداقَة	N	friendship
تَمَنَّى	V	desire
عَذاب	N	pain
مِعْرِفَة	N	(to)_know
مُباشَرَة	N	beginning
سِكِت	V	be_silent
نِيابِيّ	ADJ	representative
تَواطُؤ	N	connivance
دَين	N	debt
هَتْك	N	tearing_apart
جَمْع	N	gathering
تَلَوُّث	N	pollution
أَنْتَج	V	produce
مُشَوَّش	ADJ	disturbed
لَعِين	ADJ	cursed
أَلَم	N	pain
حُرْقَة	N	burning
مَصِير	N	path
طُغْيان	N	oppression
سُكُوت	N	silence
عار	N	shame
صَمْت	N	silence
تَمْشِيَّة	N	Gloss
خِيانَة	N	treason
تَوَقُّف	N	stop
هَدْم	N	demolition
تَسامُح	N	tolerance
جَدِّد	V	renew
اِسْتِجابَة	N	a_response
مُواصَلَة	N	continuation
اِسْتِرْداد	N	reclamation
مَنْهُوب	ADJ	plundered
مُنْتَخَب	ADJ	elected
مُزَوَّر	ADJ	falsified
شَخْطَة	N	shout
مِسْتِفِزّ	ADJ	Gloss
مِسْتَفِزّ	ADJ	Gloss
اِكْتَشَف	V	discover
مِتْمَيِّز	ADJ	discriminating
راجِع	ADJ	returning
مُعْتَرِض	N	opposed
ضَرُورِي	ADJ	requisite
بَلْوَة	N	catastrophies
حالِي	N	actual
ظَبَّط	V	tune
ضَمِّن	V	gather
قُلَيِّل	ADJ	little
رَغْي	N	Gloss
مانِع	ADJ	preventing
أَجِّل	V	put_off
حَمَى	V	defend
تَحْوِير	N	alteration
اِتْحَقَّق	V	materialize
زَعْلان	ADJ	angry
نَوَّر	V	shed_light
تِرْم	N	technical_term
اِعْتَصَم	V	go_on_a_sit-in_strike
مِتْخِيِل	ADJ	Gloss
ضَرِيبَة	N	tax
سايِب	ADJ	leaving
إِنْجاز	N	implementation
بَدء	N	start
اِنْتَظَم	V	be_organized
تَواجُد	N	presence
أَخْلَى	V	allow
اِسْتِكْمال	N	termination
تِجارَة	N	commerce
أَزْرَق	ADJ	blue
جاكِت	N	jacket
حَرَّص	V	Gloss
تَدْرِيبِي	ADJ	training
مُهِمَّة	N	task
اِسْتِعانَة	N	assistance
جامِع	N	comprehensive
مُراقَبَة	N	surveillance
تَنْسِيق	N	coordination
مُعِيد	N	tutor
مُعاوَنَة	N	assistance
دار	N	house
حَب	V	want
إِذْن	N	permission
قَمَرايَة	N	moon
مُتَواجِد	N	present
مِتعَوِّد	ADJ	used
مِدَرَّب	ADJ	trainer
مُخالَفَة	N	infringement
مُصَغَّر	ADJ	diminished
اِتْأَخَّر	V	be_postponed
اِلْتِزام	N	obligation
لَغَى	V	cancel
يَسَّر	V	facilitate
رَسَّى	V	grant
أَكْرَم	V	honor
مُزْعِج	ADJ	annoying
مُرْعِب	ADJ	frightening
كَسَّر	V	shatter
اِسْتِقْبال	N	receive
اِنْزاح	V	depart
رَمَضان	N	Ramadan
تَخْصِيص	N	designation
نَظِير	N	counterpart
قِيام	N	undertaking
بُطُولَة	N	championship
تِلْفِزيُونِيّ	ADJ	television
آن	V	arrive
أَوان	N	time
مَقْبُول	ADJ	accepted
فَنّ	N	art
كَسْب	N	acquisition
طائِل	ADJ	immense
دِرامِيّ	ADJ	dramatic
سابْقَة	N	precedence
أَغُسْطُس	N	August
قَول	N	statement
مُوَزَّع	ADJ	distributed
خَلِّل	V	make_sour
هَيافَة	N	pettiness
تِرتان	N	such_and_such
صَرَّف	V	exchange
خَيالِيّ	ADJ	imaginary
دِقِيقَة	N	minutes
اِسْتِفادَة	N	Gloss
خِسِر	V	lost
أَنْعَم	V	make_pleasant
عِدِل	ADJ	straight
مُرِيع	ADJ	dreadful
قَلِّل	V	reduce
كام	N	Gloss
تَحْضِير	N	preparation
حَلَقَة	N	ring
مِشَخَصاتِي	N	actors
تَقْنِيَّة	N	technique
بَيّ	N	father
هَدّ	V	be_weak
شَماتَة	N	gloating
أَخْفَى	V	hide
سُخُونَة	N	heat
مَناخ	N	climate
تِجاه	N	towards
نَفْط	N	petroleum
نَوَوِيّ	ADJ	nuclear
زَحْف	N	crawling
مَثِيل	N	equal
حَزِّن	V	afflict
اِرْسال	N	transmission
فاق	V	surpass
قَرَأ	V	read
خَلِيجِيّ	ADJ	(Persian)_Gulf
عانَى	V	suffer
جَفاف	N	dryness
حَصَد	V	harvest
اِتْقَدِّم	V	advance
ضَئِيل	ADJ	small
بَعَد	V	be_distant
أَبَيه	N	Gloss
اَحْيان	N	Gloss
اِعْتِماد	N	recognition
مُتْعِب	ADJ	disturbing
عَصَب	N	nerve
تِعِب	V	be
مُرْهَق	ADJ	oppressed
قَلْقان	ADJ	worried
سَقَّط	V	knock_down
عَزّ	V	be_strong
تَبَع	N	follower
خَطَّط	V	plan
نَفْسِيّ	N	Gloss
لِيَّة	N	Gloss
رَهْبَة	N	fear
مِعْيار	N	standard
قَوِي	N	strong
نَوم	N	sleep
مُذاكْرَة	N	Gloss
حَتْمِيّ	ADJ	definitive
نَفْسِيّ	ADJ	mental
تَجْرُبَة	N	experience
عَمْيان	ADJ	Gloss
جَوّ	N	climate
جَرَّب	V	test
خَلّاق	ADJ	creator
دار	V	go_around
فاتُورَة	N	invoice
نَظافَة	N	cleanliness
دَفْع	N	pushing
سُرْعَة	N	speed
اِبْداع	N	originality
ضَلْمَة	N	darkness
تَلّاجَة	N	refrigerator
اِبْتِسامَة	N	smile
صافِي	ADJ	pure
بِكِينِي	N	Gloss
رَقّاص	N	dancer
رَقَص	V	dance
فَنّان	N	artist
حُصان	N	horse
كامِيرا	N	camera
طَيِّب	N	pleasant
دِعايَة	N	propaganda
تَفاعُل	N	interaction
أَغْرَى	V	incite
مَدَنِيّ	N	civilian
شَهامَة	N	audacity
كَرَم	N	generosity
عِنِيَّة	N	Gloss
خالِي	ADJ	empty
اِكْتِمال	N	completion
كَبَى	V	become_dull
نِمْر	N	Gloss
فَضَّل	V	prefer
كَسَل	N	laziness
تِكْنُولُوجيا	N	technology
طاقَة	N	energy
اِتْنازِل	V	give_in
مِنَوَّر	ADJ	shedding_light
كُوكاكَولا	N	Gloss
مُتَغَيِّر	ADJ	changing
زُجاجَة	N	bottle
مِتْأَكِّد	ADJ	certain
مَشْرُوب	N	beverage
نِفِع	V	utilize
اِسْتِثْناء	N	exception
شِرْكَة	N	association
فَرَنْسِيّ	ADJ	French
اَساس	N	Gloss
سَرَح	V	go_away
جِسْم	N	body
كالْسِيُوم	N	Gloss
حَولَ	N	around
مَعْلُومَة	N	piece_of_data
حِصَّة	N	share
تَسْوِيقِيّ	ADJ	marketing
صِناعَة	N	manufacture
كِمِّيَّة	N	quantity
تَسْوِيق	N	marketing
مِساحَة	N	surface
صانِع	N	manufacturer
اَلْمانِي	ADJ	German
أَجْوَد	ADJ	better
مِينِي	N	mini-
مَصْنُوع	ADJ	manufactured
مارْكَة	N	trademark
جَودَة	N	excellence
نَبْض	N	beating
دَفْعَة	N	push
ظُهُور	N	appearance
حِجاب	N	veil
لَجْنَة	N	council
شاشَة	N	screen
حَمَل	V	carry
قُدُّوس	N	Gloss
اِجْراء	N	conducting
تَعَسُّفِي	ADJ	arbitrary
سِكِرْتَير	N	secretary
صَدَر	V	be_published
مُذِيع	N	broadcaster
ثَقافِي	ADJ	intellectual
مَعْنِيّ	ADJ	concerned
عَلِيّ	ADJ	supreme
مُحْزِن	ADJ	grievous
اَجْنَبِي	N	foreigner
مِتحَجِّب	ADJ	veiled
فَضائِيّ	N	satellite
حَبِيبَة	N	Gloss
زِعِل	V	grieve
غَرَض	N	goal
قَرَ	V	read
مُحَجَّب	ADJ	veiled
بَنُّوتَة	ADJ	coward
مَضَى	V	continue
مُخَصَّص	ADJ	designated
عُدْوانِيّ	ADJ	hostile
نَطَق	V	speak
ضاد	N	Dad_(Arabic_letter)
صَبَّر	V	preserve
قِرائَة	N	reading
أَفاد	V	report
اِسْتِبْعاد	N	ruling_out
صَنْدُوق	N	bin
بَنَفْسِجِي	ADJ	violet
طَيّارَة	N	aero_plane
لَقْطَة	N	picture
لِبّايَة	N	seeds
مُوَقَّر	ADJ	respected
جَلْسَة	N	session
عِلاوَة	N	increase
دَفْتَر	N	notebook
سِيادَة	N	sovereignty
مَظْلُوم	ADJ	oppressed
لاعِب	V	jest_with
أَفْظَع	ADJ	most_abominable
مَدّ	N	reach
ظالِم	ADJ	oppressive
مَدِيد	ADJ	prolonged
حَدِيد	ADJ	strong
قَطَع	V	cut_off
ساكِن	N	residents
قاعِد	ADJ	sitting
اِتْأَكِّد	V	become_sure
خَرَّج	V	oust
عَرَّف	V	acquaint
وُضُوح	N	clarity
مُبَرِّر	N	excuse
مُغَلَّف	ADJ	wrapped
تَمْكِين	N	enabling
لِزِم	V	be_necessary
بَخْس	ADJ	low
بَصَلَة	N	an_onion
عِلْمِي	ADJ	academic
أَهَمّ	ADJ	more
دِينِي	ADJ	religious
اِتْوَلَد	V	Gloss
كِسِب	V	gain
مُحِيط	ADJ	surrounding
مِسْتَسْمَر	ADJ	investing
خَرْبان	ADJ	Gloss
فَرَش	V	spread
زَحْمَة	ADJ	crowded
مِولَّع	ADJ	high
اِزْدِياد	N	increase
قُوت	N	nourishment
لَيّ	N	bending
نَهَب	V	plunder
مَقْهُور	ADJ	defeated
غَصْب	N	extortion
مُفْتَرَض	ADJ	supposed
مُكافْحَة	N	confrontation
تَعْرِيف	N	identification
مُحَدَّد	ADJ	set
مُدَوَّن	N	record
مُسَمَّى	ADJ	called
عَون	N	assistance
لَفّ	V	wrap
كاشِف	N	examiner
عارِم	ADJ	violent
أَعْدَم	V	deprive
ساد	V	prevail
عَشِّش	V	build_a_nest
فَوضَى	N	chaos
نِفُوذ	N	power
مُواجِه	ADJ	facing
خَرَس	V	dumbness
عَسْكَرِي	N	soldier
نِيَّة	N	intention
حَشِيشَة	N	herb
شارِب	ADJ	drinking
سِيجارَة	N	cigarette
أَمِّن	V	assure
اِنْتِقال	N	transfer
أَكْل	N	eating
مُلَوِّث	N	pollutant
اَوِّل	ADJ	top
بَوّاب	N	doorman
جَبان	ADJ	coward
اِتحَدَّى	V	challenge
لاحِظ	V	observe
مِشِي	V	go
مَكْسُوف	ADJ	Gloss
سَجِّل	V	inscribe
أَخْرَة	N	hereafter
جَلّ	V	be_majestic
اِهْداء	N	presenting
مُناسْبَة	N	festivity
سابِق	N	former
هَدَّى	V	get_calm
نَظِيف	ADJ	clean
بائِد	ADJ	bygone
صِدْق	N	sincerity
داء	N	disease
مَناعَة	N	impenetrability
اِعْتِيادِي	ADJ	normal
داهِم	ADJ	looming
اِحْتَفَظ	V	keep
بَنْد	N	article
قَضائِي	ADJ	judicial
جَماعِيّ	ADJ	social
صَفْعَة	N	slap
قَوِيّ	ADJ	strong
مُؤَثِّر	ADJ	influential
كِمالَة	N	support
سَلِيم	ADJ	safe
وَطَنِي	ADJ	national
نُهُوض	N	promotion
شَرْعِيَّة	N	legitimacy
مُغْتَصَب	ADJ	usurped
مُسْتَبِدّ	ADJ	autocratic
أَخْد	N	seizure
زَعَّق	V	shout
دُسْتُورِي	ADJ	constitutional
مَدَى	N	extent
مَتانَة	N	firmness
زَمَن	N	time
شَغّال	ADJ	busy
عال	N	Gloss
تَصَرُّف	N	behavior
أَنْزَل	V	bring_down
مُوافِق	N	agreeing
مُوافْقَة	N	solution
مِدَنِّي	ADJ	Gloss
شِبْه	N	like
اِجْماع	N	consensus
اِتِّفاق	N	accords
داعِي	ADJ	calling_on
حَيْث	N	Gloss
كَوِّن	V	make
تَوَصُّل	N	attainment
حَقَّة	N	Gloss
أِجْتِماعِي	ADJ	social
كَفالَة	N	bail
نَزِيه	ADJ	blameless
مُتَكافِئ	ADJ	alike
إِنْتِخاب	N	selection
تَشْرِيعِيّ	ADJ	legislative
الإِنْتِخاب	N	selections
رِئاسِيّ	ADJ	presidential
عَرِيض	ADJ	wide
اِشْراف	N	supervision
إِنْتِخابِي	ADJ	selection
رِقابَة	N	censorship
الإِنْتِخابات	N	selections
خاصَّة	N	elite
مُنَسِّق	N	coordinator
وَقَع	V	fall_down
هِمَّة	N	ambition
سَلْبِيَّة	N	negativism
فَرْعَن	V	tyrannize
قَولَة	N	remark
لَقِي	V	meet
وَدَّى	V	carry
آَل	N	family
مُتْشَكِّر	N	thankful
ضِيافَة	N	hospitality
عِيشَة	N	sustenance
مِرَحْرَح	ADJ	resting
ظَبَط	V	regulate
يَنْسُون	N	aniseed
سَلْبِي	ADJ	passive
حاجَة	N	need
صَباح	N	morning
مِبَقْلَظ	ADJ	Gloss
وَرْدِيّ	ADJ	rosy
خُرُوج	N	exit
مَقْفُول	ADJ	Gloss
غُلْب	N	suffering
رَيَّح	V	make_rest
لَوزَة	N	an_almond
مُفاجْأَة	N	surprise
كاتِب	ADJ	writing
مُتَفَرِّق	ADJ	dispersed
قَنْدِيل	N	lamp
مَعْمَعَة	N	confusion
لَحَق	V	follow
عَمّال	N	Gloss
تِذْكارِي	ADJ	memorial
مَنْطِقَة	N	territories
مَوزَة	N	a_banana
جْرِي	V	Gloss
اِعْصار	N	tornado
لَحْظَة	N	moment
إِنتَهَك	V	exhaust
اِحْساس	N	feeling
غُرْبَة	N	exile
طَبْع	N	temperament
راجِل	N	man
أَخَّر	V	delay
اِتْوَغِّل	V	make_an_incursion
دَحَّك	V	make_laugh
صَحَّى	V	awaken
تَجْرِبَة	N	experience
طِيبَة	N	good_nature
مَضْرُوب	ADJ	multiplier
اِنْعِدام	N	absence_of
مُظْلِم	ADJ	dark
اِتْمَدّ	V	extract
مِخَلِّي	ADJ	Gloss
لَزْق	N	adhering
وَحَش	V	search_for
سَهْلاً	N	Gloss
كَيّ	N	ironing
مِتْوَقَّع	ADJ	Gloss
قَبَل	N	before
مَأْمُور	ADJ	ordered
فَضْح	N	humiliation
لَفْت	N	directing
تَأْيِيد	N	support
مُعامْلَة	N	treatment
تَوَتُّر	N	tension
وِجْهَة	N	point_of_view
مُرَشَّح	N	candidate
مُتَّبَع	ADJ	followed
أَضْحَى	V	bring_to_light
آفَة	N	vice
آلِيَّة	N	automation
أَرْسَل	V	send
بِعْثَة	N	missions
مَجّانِي	ADJ	free
مُنْتَظِم	ADJ	regular
مُنْفَتِح	ADJ	open
مُتَعَلِّم	ADJ	educated
مُزَيَّف	ADJ	forged
عَرَض	V	exhibit
ٱِبْن	N	son
تِكْنُولُوجِيّ	ADJ	technological
جِهاز	N	machine
كُمْبِيُوتَر	N	Gloss
طِراز	N	model
بَدأ	N	beginning
نِظام	N	regime
مَدْسُوس	ADJ	fake
مُتَخَصِّص	ADJ	specialized
دِراسِي	ADJ	educational
مِعَلِّم	N	masters
مُعَلِّم	N	teacher
سَخاء	N	generosity
مُخْطِئ	ADJ	mistaken
دائِم	ADJ	permanent
تَفْرِقَة	N	segregation
نَقْدِيّ	ADJ	monetary
مُرْجِع	ADJ	expert
آلَة	N	instrument
عاقِب	V	punish
صَلاحِيَّة	N	practicability
إِسْتَخْدَم	V	use
طَفْرَة	N	leap
اِسْتَخْدَم	V	use
ضَمان	N	guarantee
مُتَنَوِّع	ADJ	diverse
تَحْتِيّ	ADJ	under
بُنْيان	N	structure
خِجِل	V	be_ashamed
فَرْط	N	excess
راكِد	ADJ	stagnant
طِين	N	clay
مُنهَطِل	ADJ	falling
تَهَتُّك	N	immorality
غِلْظَة	N	thickness
تَعَرُّج	N	zigzag
وَعْر	N	rugged_terrain
راكِب	N	rider
غَرامَة	N	fine
اِيقاع	N	rhythm
صِناعِيّ	ADJ	industrial
إِجعَل	V	make
دَخَّل	V	enter
خَشْيَة	N	fear
رَدِيء	N	malicious
صُنْع	N	manufacture
اِفْتَرَض	V	suppose
قُمامَة	ADJ	rubbish
حالِيّ	N	Gloss
كافِي	ADJ	sufficient
اِعْتَزّ	V	be_proud
خِزْي	N	shame
مُتَقَدِّم	ADJ	advanced
نِدِيّ	N	computition
تِرْسانَة	N	arsenal
مِتْجَمَّع	ADJ	Gloss
تَنافُس	N	competition
مُنافْسَة	N	rivalry
وَحْي	N	inspiration
مِسَبَّق	ADJ	Gloss
قُصُور	N	shortcoming
أَمَل	V	hope_for
تَدَهْوُر	N	deterioration
نُطْق	N	pronunciation
اِنْتِخابِي	ADJ	selection
اِتْطَبَّق	V	apply
مُنْتَخَب	N	national_team
ثانْيَة	ADJ	second
عافِيَة	N	good_health
لَمَّة	N	collection
بَرَز	V	appear
خَلَف	V	succeed
حِزْب	N	party
اِعْتِياد	N	habituation
إِنْتِقاد	N	censure
قُبُول	N	acceptance
أَفْسَح	V	make_room
مُكَثَّف	ADJ	intensive
بارّ	ADJ	pious
مُحَيَّر	ADJ	embarrassed
كَئِيب	ADJ	depressed
راقِص	N	dancing
مِتْبَسِّم	ADJ	Gloss
غائِب	ADJ	absent
تَرْشِيح	N	nomination
مَحاسِن	N	merits
مَجْلِس	N	council
سَيطَر	V	dominate
سَنِّيد	N	Gloss
دِماء	N	blood
مَوْضُوعِيّ	ADJ	objective
الإِجْتِماعِي	ADJ	social
هَبَط	V	land
بَراشُوتّ	N	umbrella
حُضْن	N	arms
حِزْبِي	ADJ	factional
إِخْتِيار	N	selection
إِسْتَشْعَر	V	have_a_premonition_of
خُطُورَة	N	importance
كَعْك	N	cake
فَصَّل	V	classify
مَقاس	N	measuring
مُنْقَسِم	ADJ	divided
يَسِير	ADJ	easy
اِنْشِغال	N	preoccupied
مُتَخَبِط	ADJ	confused
دُسْتُورِيَّة	N	constitutionality
غَضاضَة	N	freshness
مَعْرِفَة	N	(to)_know
مِتخَبَّط	ADJ	hasitating
اِتْوَقَّف	V	stop
إِنْقِياد	N	submission
أَحدَى	N	one_(of)
تَسْقِيع	N	Gloss
رَعِيَّة	N	subject
الإِنْتِخابِيّ	ADJ	selection
قَذِر	ADJ	impure
اِشْعال	N	Gloss
رَقِيق	N	slaves
سَفِيه	ADJ	foolish
عامِل	N	worker
قَذارَة	N	filth
رَنّان	ADJ	resounding
اِسْتَمَع	V	listen
رُخْص	N	cheapness
مِرَخَّص	ADJ	Gloss
لِقِي	V	find
مِفْتِرِي	ADJ	liar
صَدَق	V	be_sincere
حَرْف	N	letter
مُهان	ADJ	humiliated
صِعِب	V	sympathize
عُزُومَة	N	invitation
مَغارَة	N	cave
مَتِين	ADJ	firm
رُطُوبَة	N	moistness
طُوبَة	N	rocks
مَعْطُوب	ADJ	damaged
مُنْدَسّ	ADJ	inserted
فَوِّت	V	let_go
مِعَفِّن	ADJ	skeptic
جَدَع	N	youth
مُبَيِّت	ADJ	plotting
لُعَيْبَة	N	little_doll
مَدهُون	ADJ	painted
رَمْي	N	throwing
جِتَّة	N	corpse
مِتهان	ADJ	humiliated
كَرَوِي	ADJ	spherical
أَرْبَع	N	wednesday
جَزائِرِيّ	ADJ	Algerian
مَحَلّ	N	place
مُشْكِل	N	problem
فار	V	boil
هادِئ	ADJ	calm
دَنَب	N	tail
دَلَك	V	rub
هَجّان	N	camel_jockey
فُرْقَة	N	disunity
حَمِيَّة	N	zeal
مَسْدُود	ADJ	blocked
تَعْبِئَة	N	mobilization
هَمّ	N	concern
مَسْأَلَة	N	issue
صَفْو	N	clarity
تَمْثِيل	N	representation
اِتْعَرَّض	V	be_exposed
فَرْدِي	ADJ	single
مَسْئُول	ADJ	Gloss
حِفاظ	N	preservation
مَحَبَّة	N	love
حَزْم	N	determination
فَتَك	V	destroy
اِسْتِغاثَة	N	call_for_help
حُدُوث	N	occurrence
نَسْج	N	weaving
مَفْضُوح	ADJ	disgraced
تَكْسِير	N	fragmentation
زُجاج	N	glass
تَلْطِيخ	N	Gloss
صَلْصَة	N	sauce
لَون	N	color
مُعامَلَة	N	treatment
اِثارَة	N	provocation
طاوْلَة	N	table
فَنِّي	ADJ	artistic
مَبْدَأ	N	principle
سَرَّب	V	leak_(news
وَجَب	V	be_necessary
تَضْخِيم	N	inflating
مُشَيِّن	ADJ	disgraceful
غَيبُوبَة	N	unconsciousness
مِتْعَرَّض	ADJ	Gloss
أَرْقَى	ADJ	more_high_class
آسِف	ADJ	sorry
أَفْسَد	V	spoil
جِنائِي	ADJ	penal
مُشَجِّع	ADJ	encouraging
قَذَف	V	strafe
مَعْتُوه	ADJ	insane
رَسَم	V	trace
ذَهَب	V	go
خَرَب	N	ruins
أَخْطَأ	V	be_wrong
اِخْتَرَع	V	invent
أَساء	V	harm
تِيمَة	N	issue
اِسْتاد	N	stadium
أَجْهَل	ADJ	more_ignorant
زِفْت	N	asphalt
جَلْد	N	whipping
غِلّ	N	rancor
حِمَقِي	ADJ	nervous
كَرَه	V	hate
نابِع	ADJ	emerging
نِهائِي	ADJ	definitive
مُصالْحَة	N	conciliation
رَسْمِي	ADJ	officially
حُكُومِي	ADJ	official
حِجَّة	N	pilgrimage
مَطافِي	N	extinguishing
مُسَيِّل	ADJ	making_flow_(tear_gas)
اَذَى	V	Gloss
مَحْسُوم	ADJ	concluded
شَحَن	V	ship
مَوْقَعَة	N	battlefield
تَحْلِيل	N	analysis
مُؤَكَّد	ADJ	certain
مُقَدَّم	ADJ	offered
صُفّارَة	N	whistle
حَكَم	N	arbiter
اِنْتِصار	N	victory
اِحْتِراف	N	professional
فَنِّيّ	ADJ	technical
مِدَوِّي	ADJ	screaming
تاه	V	go_astray
خِدْعَة	N	deception
جَنَى	V	commit_a_crime
جِنايَة	N	crime
اِرْتِياح	N	satisfaction
عَشَرَة	N	ten
سُودانِي	ADJ	Sudanese
تُوك	N	talk
هِدِيَّة	N	presents
تَذْكَرَة	N	ticket
مَسْؤُول	ADJ	responsible
مِصَدَّق	ADJ	Gloss
غَرْب	N	west
مَصْراوِي	ADJ	cairene
قُرْب	N	near
شُيْكُولاتَة	N	Gloss
وَعَد	V	promise
حِتَّة	N	morsel
مُتَغَطْرِس	ADJ	arrogant
هامِم	ADJ	be_concerned
زَرَع	V	plant
رَزْع	N	Gloss
مِشَقْلِب	N	upside_down
شَخْبَطَة	N	scribbling
رَشَّح	V	nominate
قَفِّل	V	close
سابِت	ADJ	Gloss
مُسَكِّن	ADJ	sedating
مِصَدَّع	ADJ	be_annoyed_to
مُتَخَلِّف	ADJ	backward
أَجِنْدَة	N	notebok
مَبْهُور	ADJ	out_of_breath
مِزَوَّق	ADJ	Gloss
اِسْتِعْطاف	N	entreaty
أَكِّل	V	feed
عَسَل	N	honey
مَسْمُوم	ADJ	poisoned
مِرَيَّح	ADJ	put_at_ease
إِبْن	N	son
زِمَّة	N	moral
اِحْتِمال	N	probabilities
ذَكِي	ADJ	clever
سَوَر	V	enclose
لَيلَة	N	night
سِحْرِي	ADJ	magic
سِحْرِيّ	ADJ	magic
صِراع	N	struggle
مُضادّ	ADJ	anti-
لاق	V	be_proper_for
مُغَفَّل	ADJ	apathetic
إِنتِخاب	N	selection
عَرْبُون	N	presenter
تَناقُض	N	inconsistency
صَدْر	N	chest
عايِش	N	living
سَطْحِيَّة	N	flatness
مَبلُوع	ADJ	swallowed
لام	V	blame
أَظْهَر	V	show
خَطَب	V	address
رِفْعَة	N	height
جُهْد	N	strain
أَدَّى	V	direct
واصِل	V	continue
مُفاوْضَة	N	talks
مَنطِقِيَّة	N	logic
مُعْتَرَف	ADJ	recognized
سِلاح	N	weapon
أُبْنَة	N	Gloss
مُدَلَّل	ADJ	pampered
مَبْعُوث	N	envoy
اِسْتِسْلام	N	surrender
مِكَوِّم	ADJ	Gloss
هُبُوط	N	landing
اِنْطِباع	N	impression
هامِش	N	margin
جِدّ	ADJ	Gloss
دِبَّة	N	Gloss
وِقِع	V	fall
بِير	N	well
مِسْتَقْوِي	ADJ	Gloss
سِكَّة	N	road
باقِي	N	remaining
فُلّ	ADJ	Arabian_jasmine
مِوَحِّد	ADJ	Gloss
بَطّارِيَّة	N	battery
مُوسِم	N	season
نَومَة	N	sleep
نَهارْدَه	N	Gloss
ضايِع	ADJ	be_lost
لَزْمَة	N	official_concession
قَلَم	N	pencil
شَلُّوت	N	a_kick
مُعاد	ADJ	repeated
سَمِج	ADJ	disgusting
إِمْرَأَة	N	woman
مُلتاع	ADJ	suffering
طَلّ	V	sprinkle
فانِلَّة	N	flannel
مُخَطِّط	ADJ	planner
فائِق	ADJ	boundless
اِمْساك	N	seizing
عَلْقَة	N	a_whang
سِكِّير	N	heavy_drinker
مُجْرِم	ADJ	criminal
آيَة	N	Quranic_verse
خَطَف	V	abduct
مُحاوِل	ADJ	attempting
وَسِيم	ADJ	graceful
بارِيسِيّ	ADJ	Parisian
أَقَلّ	ADJ	least
مُعْتَبَر	ADJ	considered
عِطْر	N	perfume
مَجْنِيّ	ADJ	victimized
خَلْف	N	behind
يَدّ	N	hand
مِقاوِل	N	contractor
عِكمَة	N	pack
اِعْتِبارِي	ADJ	consideration
بَيه	N	Gloss
مُكَلَّف	ADJ	commissioned_with
واد	N	boy
شَفْتُورَة	N	thick_lip
قِرْش	N	piaster
حِيلَة	N	stratagem
مُسْتَهْلِك	N	consumer
رُقْعَة	N	patch
تَصْدِير	N	export
مُقارَنَة	N	comparison
تَفَشِّي	N	spreading
تَفْضِيل	N	preference
مُسْتَهْلِك	ADJ	consumer
فَلّاح	N	peasant
طُوفان	N	deluge
كَهْرَبا	N	electricity
بَطْن	N	stomach
وَجِيعَة	N	sufferings
مُفْرَغ	ADJ	emptied
مَبْنِيّ	ADJ	built
كَسُول	ADJ	Gloss
راقِب	V	supervise
اِكْتِفاء	N	sufficiency
سَنَمَة	N	summit
عِيد	N	feast
صَرْخَة	N	shout
أَرْكَز	ADJ	more
اِسْتَهْدَى	V	seek_the_right_road
طَفَشان	N	escape
بَهْدِل	V	ridicule
مُشْرِف	ADJ	supervising
اِنْتِخابِيّ	ADJ	selection
مَهابَة	N	fear
اِتْخَلَّص	V	get_rid_of
مِسْكِين	ADJ	needy
مِكافِح	ADJ	Gloss
مِوازْنَة	N	budget
مُسْتَشْفَى	N	hospital
مالِي	ADJ	filling
غَطَّى	V	cover
عَلَن	N	in_public
هُوَّة	N	abyss
تَساهُل	N	indulgence
اِسْتِعْمال	N	use
تَنْبِيه	N	warning
لَفَت	V	turn
أَصاب	V	strike
وُقُوف	N	standing
غَنِي	ADJ	wealthy
غَفِير	N	guard
جَرِيمَة	N	crime
ناتِج	ADJ	resulting_from
وَسْطِيَّة	N	patio
تَطَرُّف	N	extremism
مِطالِب	N	demanding
قابِع	ADJ	lonely
ذَكِيّ	ADJ	intelligent
طَلَب	N	quest
مُتسَوِّل	ADJ	beggar
مِتْطَمِّن	ADJ	Gloss
مَدّ	V	extend
عَصَبِيَّة	N	chauvinism
نَضِيف	ADJ	dirty
وَجَع	V	ache
خَطَأ	N	mistake
أَكِيد	ADJ	certain
مُعْتَدِي	ADJ	aggressor
مُناقْشَة	N	debate
هادِي	ADJ	guider
هادِف	ADJ	aiming_(at)
بَشِع	ADJ	ugly
شَحّات	N	beggar
تَوك	N	talk
سِينِما	N	cinema
مَسْخَرَة	N	ridiculous
لامِس	V	touch
رَذِيلَة	N	vice
اِتْدايِق	V	be_bothered
خَمْرَة	N	wine
اِنْحِدار	N	decline
مُنْقَطِع	ADJ	interrupted
خَلِيع	ADJ	deposed
نَدَر	V	be_rare
رَخَّص	V	authorize
مِستَخَبِّي	ADJ	hiding
فَضِيلَة	N	virtue
أَسَف	N	regret
تَغَيُّر	N	change
مُتَّفِق	ADJ	in_agreement
ماسُورَة	N	pipe
جِعِير	N	loud_protestation
سُخْن	ADJ	hot
مُشاهِد	N	viewer
مُعْلِن	N	announcer
تَخْرِيف	N	delusion
وَطَنِيَّة	N	nationalism
نَبْع	N	emergence
مُتَدَيِّن	ADJ	pious
شَكْلِي	ADJ	basic
فَتاه	N	girl
مُطِيع	ADJ	obedient
اِلآَن	N	Gloss
وَقِح	ADJ	insolent
مِيزانِيَّة	N	budget
مُنْتِج	N	manufacturer
تَرْجِم	V	translate
مُبالَغ	ADJ	exaggerated
حُلُول	N	advent
سُوء	N	offense
خَلاعَة	N	licentiousness
رَقْص	N	dancing
آدَمِيَّة	N	humanity
مُرافِق	ADJ	accompaning
سِياحِيّ	ADJ	tourist
مُبهِر	ADJ	impressive
خِفَّة	N	lightness
تِلْقائِيَّة	N	spontaneity
دَعارَة	N	indecency
فاطِس	ADJ	dead
كَمان	N	violin
مَفْرُود	ADJ	Gloss
مَوجَة	N	wave
سِيرَة	N	biography
تُرْكِيّ	ADJ	Turkish
اِتْحَسِّن	V	improve
رُزَّة	N	rice
شَهْوَة	N	desire
فِعْل	N	doing
اِنْتَقَم	V	take_revenge
مُغْلَق	ADJ	closed
عَرِيس	N	bridegroom
عَرُوسَة	N	bride
أَزْعَج	V	bother
فاحِشَة	N	whore
أَتْحَف	V	present
تَقْلِيعَة	N	eccentricity
تَرْحِيب	N	welcoming
تَخَرُّج	N	graduation
مَسْبُوق	ADJ	precedented
مَهارَة	N	skill
شِرِيك	N	cake
ناجِح	N	winner
اِتْمَتَّع	V	enjoy
زَوجِيَّة	N	Gloss
سَعِيد	ADJ	happy
اَهْلِي	ADJ	Gloss
مادِّي	ADJ	bodily
مَعُونَة	N	aid
قائِل	ADJ	saying
اِسْتَعَدّ	V	get_ready
نُضْج	N	Gloss
مِثالِيّ	ADJ	ideal
اِسْتَطْلَع	V	lok_incrutinize
أَيِّد	V	approve_of
سَخَر	V	ridicule
اِحْتِكاك	N	friction
قُصَيَّر	ADJ	short
اِقْتَرَح	V	suggest
مَرِح	N	cheerful
مُعَقَّد	ADJ	complicated
قَرِيب	N	relative
مُقابْلَة	N	meeting
مُحاسِب	N	accountant
مِعَقَّد	ADJ	intricate
مُمِلّ	ADJ	boring
مُوَضِّح	ADJ	clarifying
تَجْهِيز	N	equipment
وِدْن	N	ears
مُسْتَساغ	N	palatable
مُستَهجَن	ADJ	not_serious
اِبْتَدا	V	begin
صارِم	ADJ	severe
اِسْتَفَزّ	V	make_someone_angry
اِسْتِهْبال	N	Gloss
اِسْتِخْفاف	N	facilitation
عِشْرَة	N	association
بَلاش	ADJ	for_free
كَتَّر	V	multiply
شَغَّل	V	employ
رِحْلَة	N	career
شَبابِيّ	ADJ	youthful
مَعْمُول	ADJ	applied
شَغُوف	ADJ	enamored
ماسّ	ADJ	urgent
بَحتَة	N	exclusive
حَصَر	V	surround
مُسْتَنْقَع	N	quagmire
مُقَنَّن	ADJ	standard
جِرِي	V	go
مُنْفَصِل	ADJ	separate
مُبَجَّل	ADJ	revered
فارِق	ADJ	distinctive
حَدّ	V	delimit
جَوز	N	heart
بَشَرِيّ	ADJ	human
زِهِق	V	die
شَرْح	N	explanation
عَورَة	N	imperfection
هَيكَل	N	framework
شَرّ	N	evil
مَرْغُوب	ADJ	desired
فِتْرَة	N	phase
خَضّ	V	shock
أَرْمَنِيّ	ADJ	Armenian
سِمْنَة	N	fat
بِبْسِي	N	Gloss
آَيِس	V	despair
كِرِيم	N	Gloss
مَرْحُوم	ADJ	deceased
اِتْفَسَّح	V	go_for_a_stroll
غَلْبان	N	needy
غَلْبانَة	ADJ	por_fellow
مِخَدَّة	N	cushion
أَنْتِرَيه	N	informal_sitting_room
أَوَّلانِي	ADJ	Gloss
فَرْخَة	N	hens
شِوَيَّة	N	few
قِيامَة	N	resurrection
دِقَّة	N	minuteness
حَضَّر	V	prepare
كُومِيدِي	ADJ	comic
جُوَّة	N	in_side
حُفْرَة	N	pit
مُفاجِئ	ADJ	surprising
مُرْتاح	ADJ	relaxed
طَبَق	N	dish
وَلَّع	V	kindle
حَرّ	N	warmth
بَطِّيخَة	N	watermelon
مَرارَة	N	bitterness
مُلاحِظ	ADJ	observing
بَكَّى	V	make_cry
شِحاتَة	N	begging
واسْطَة	N	means
بُكْرَه	N	tomorrow
مُعْدِم	ADJ	lacking
مُتَوازِن	ADJ	balanced
فَجْوَة	N	gap
مُنْتَج	N	product
مَنْطِقِيّ	ADJ	logical
فاتِح	ADJ	opener
هَمْبَكَة	N	squandering
نِعْمَة	N	blessing
أُسْطُوانَة	N	cylinder
نَتْع	N	raising
كِدْب	N	boasting
جَرَيان	N	flow
واكِل	ADJ	eating
تَصْوِيرِيّ	ADJ	photographic
تَصْوِير	N	photography
خَيبَة	N	disappointment
مُشَوَّه	ADJ	distorted
اِتْأَجَّر	V	be_rented
بَرَّة	N	outside
شَيف	ADJ	onlooker
وِقايَة	N	precaution
لَهْفَة	N	apprehension
شَدِيد	ADJ	intense
قَرَف	V	peel
فَرَنْساوِي	N	Gloss
دَرْس	N	studying
لَها	V	play
فَرّاش	N	valet_de_chambre
مُتَفائِل	ADJ	optimistic
غَباء	N	ignorance
بُرْص	N	gecko
مَطْحُون	ADJ	Gloss
ثِلْث	N	thirds
مَنْهَج	N	method
مُتَمَيِّز	ADJ	distinguished
حَظّ	N	luck
تَعْبِيرِيّ	ADJ	expressive
اِسْتَمِرّ	V	continue
حَزِين	ADJ	sad
قَطِيفَة	N	pastry
جَمَع	V	gather
بِرّ	N	charity
مَرَّة	N	occasion
شاهِد	ADJ	witnessing
نَمُوسَة	N	a_mosquito
قَصْد	N	intent
مُرَبَّع	N	square
مِأَجَّر	ADJ	salaried
اِتْوَسَّط	V	help_get
تَعْيِين	N	appointing
قَزَح	V	embellish
تُراب	N	dirt
مُشارَكَة	N	participation
دايْرَة	N	office
شِبْر	N	span_of_the_hand
مُؤْمِن	ADJ	believing
خَدُوم	ADJ	Gloss
حَسَب	V	compute
اِنَّهاردَة	N	today
ناسِي	ADJ	forgetful
أَصْحَى	V	awaken
قَومَة	N	revolt
فِلَّة	N	villa
شَمْعَة	N	candle
صِدْر	N	chest
مُقَرَّر	ADJ	decided_upon
اِحْصا	N	calculation
مِتْدَمَّر	ADJ	destroyed
مَضْغُوط	ADJ	compressed
اِنْجِلِيزِي	ADJ	Gloss
بَلاغَة	N	eloquence
مَقالِي	ADJ	essay
قُطْعَة	N	plot_of_land
مَعْنَى	N	meaning
غِشّ	N	cheating
عَيَّط	V	scream
فَضّ	V	break_up
بِتِنْجانَة	N	Gloss
اِنْتَحَر	V	commit_suicide
طَلَّق	V	divorce
صاحِب	V	accompany
هَيصَة	N	turmoil
دارِي	ADJ	aware
رَكِّز	V	concentrate
تَفاهَة	N	triviality
غِلِط	V	make_errors
جِيرَة	N	neighborhood
مَوَدَّة	N	friendship
طَبْلِيَّة	N	round_table
سُفْرَة	N	dining_table
بَنات	N	Gloss
قُدْوَة	N	example
غَرِيزَة	N	natural_instinct
مِرْتاح	ADJ	resting
مِتْصَوَّر	ADJ	Gloss
باقِي	ADJ	remaining
مُتَوافِر	ADJ	available
كُوسايَة	N	zucchini
اِتّاخِد	V	begin
واقِف	N	standing
اِنْتِخابات	N	elections
ثائِر	ADJ	agitated
مِخَلِّف	ADJ	Gloss
عِوا	N	Gloss
بُطُولِيّ	ADJ	heroic
فَرْحان	ADJ	cheerful
مِسَلَّط	ADJ	controlling
سامَح	V	forgive
طَقّ	V	crack
جَنابَة	N	ritual_impurity
جَدَع	ADJ	strong
حَظْر	N	prohibition
أَغْلَب	ADJ	stronger
سَقْف	N	roof
تَقْيِيم	N	evaluation
عِصْيان	N	mutiny
وَكَل	V	trust
قِرِف	V	be_disgusted
مَصلَحجِي	ADJ	greedy
اِنْتَخَب	V	vote_for
لابِس	ADJ	Gloss
هِدْمَة	N	clothes
حامِد	ADJ	commender
اِتناقِش	V	discuss
زَهْقان	ADJ	be_fed_up
زِي	N	Gloss
هارِب	N	fugitive
مُهَدَّد	ADJ	threatened
مَباحِث	N	investigation
اَصْلِي	ADJ	original
فُلّ	N	jasmine
كَرِيم	ADJ	distinguished
فَشَل	V	fail
صَبَر	V	be_patient
خايِن	ADJ	disloyal
زَهَق	V	die
اَسِف	ADJ	sorry
بَلطَجِيّ	N	ruffian
وَقَّع	V	sign
بَصِيرَة	N	insight
فاعِل	N	activist
مُتَعَمَّد	ADJ	intentional
نِضِف	V	be_clean
داخِلِي	ADJ	domestic
جَلالَة	N	majesty
مَسْؤُلِيَّة	N	Gloss
اِتْجَنِّن	V	be_crazy
تَهَجُّم	N	raid
اِستَكفَى	V	be_satisfied
شايِف	N	viewer
أاسِف	ADJ	sorry
عَصِير	N	juice
كازُوزَة	N	sweet_carbonated_beverage
اِتْحَرَّش	V	provoke
بَدال	N	substitute
دِيمُقراطِيّ	N	democrat
مُسْتَشار	ADJ	counselor
مُتَشَعِّب	ADJ	ramified
اَجْنَبِي	ADJ	foreign
فَرْع	N	branch
تَدَخُّل	N	intervention
مُصَمِّم	ADJ	determined
نَعامَة	N	ostrich
أَقْوَى	ADJ	stronger
لَعَن	V	curse
مُناقِش	ADJ	debating
اِتَّرْيَق	V	mock
اِسْتَعْمِل	V	use
شُراب	N	beverage
جِدّ	N	seriousness
غَلْطان	ADJ	wrong
غَبِيّ	ADJ	ignorant
خَبَّى	V	hide
خَدَع	V	deceive
مُدَرَّب	ADJ	trained
حَدُّوتَة	N	story_for_children
فِرِنْسِي	ADJ	French
مُهاجَمَة	N	raid
حُجَّة	N	pretext
أَراد	V	want
مُنَظَّم	ADJ	organized
زَيطَة	N	disturbance
فَكّ	V	separate
اِمْبارِح	N	yesterday
وَسَط	ADJ	intermediate
تَبَع	V	follow
كَنَبَة	N	sofa
اِتَوَفَّى	V	Gloss
عَوِز	ADJ	requiring
اِرْجاع	N	return
هَيبَة	N	fear
خَيرَة	N	good_deed
اَداء	N	performance
اِسْتِلام	N	receipt
مُباشْرَة	N	beginning
ثالِث	N	third
هَيْكَلَة	N	structuring
اِطار	N	framework
زَمَنِي	ADJ	time
مَشْهُود	ADJ	attested
اِسْتِقْلال	N	autonomy
عَطَّل	V	hinder
أِستَودَع	V	leave
مُمْتَلَك	N	property
حِفْظ	N	preservation
حافِظ	N	guardian
كَرثَة	N	catastrophes
بَكْرَة	N	reel
جايِب	ADJ	bringing
اِسكَندَرانِي	ADJ	from_Alexandria
اِتَّهَم	V	charge
ساكِن	ADJ	residing
خِسَّة	N	meanness
تَولِيع	N	ignition
شَعْلَلَة	N	igniting
اِفْتَخَر	V	feel_pride
اِتَّقَى	V	fear
مُتَعَصِّب	ADJ	fanatical
اِسكِندِرانِي	ADJ	from_Alexandria
مِتْجَهِّز	ADJ	equipped
أِسوِد	ADJ	black
بَرَّد	V	refrigerate
شَهْدَة	N	honey-dew_melon
جاوِب	V	comply
سَوَّأ	V	do_badly
بَوّابَة	N	portal
مَغْلُوب	ADJ	loser
آخِد	ADJ	taking
عَمّ	V	be_universal
اِتْوَقَّع	V	anticipate
مَوِّت	V	make_die
دِيَة	N	blood_money
كابُوس	N	nightmare
دَكَر	N	male
مَصْدُوم	ADJ	shocked
تَحْمِيل	N	burdening
سِياحِي	ADJ	tourism
زَمَنِيّ	ADJ	temporal
مُؤَدِّي	ADJ	leading
عَقَّد	V	complicate
مِتِّصِل	ADJ	continuous
اِحتَجَز	V	emprison
عازِل	ADJ	insulating
دَمار	N	ruin
قَنُونِي	ADJ	legal
ثَبات	N	reliability
نافِع	ADJ	useful
شَراسَة	N	viciousness
اِجْهاض	N	abortion
شِلَّة	N	group
اِتْسَرَق	V	be_stolen
صَعْبان	ADJ	compassionate
غَدْر	N	treason
جَرّ	N	pulling
شَكَل	N	dispute
اِتْخانِق	V	quarrel
تَسْلِيم	N	handing_over
مُؤَقَّت	ADJ	temporary
جِبْنَة	N	cowardice
سَلَفِيَّة	N	Salafiya
وَسَطِيّ	ADJ	environmental
شاطِئِي	ADJ	coastal
خَسْران	ADJ	loser
زَرْع	N	planting_(seed)
مُستَفِزّ	ADJ	challenging
اِسْتَرَيَّح	V	be_at_rest
تِكَّة	N	waistband
تِقِيل	ADJ	heavy
حِمْل	N	burden
عِزَّة	N	power
نَصَر	V	assist
شَرْع	N	law
اِحْتَرَم	V	respect
إِلٰه	N	god
قِياس	N	analogy
عاوِز	N	wanting
اِختار	V	choose
سَداح	N	Gloss
مَداح	N	Gloss
سَبَهْلَلَة	N	haphazardly
تَيَّير	N	Gloss
مِراقْبَة	N	supervision
اِتْخَلَّى	V	give_up
رِخِيص	ADJ	cheap
مِتمَسِّك	ADJ	holding
إِسْلام	N	Islam
أَذَلّ	ADJ	more_debased
فِسِد	V	become_corrupt
اِسلامِيّ	N	Islamic
خُرْم	N	hole
شَرَّع	V	legislate
غَشّ	V	deceive
مارِس	V	undertake
اِسْتَطاع	V	be_able
مُسْتَمَدّ	ADJ	taken
تِرْتِرَة	N	Gloss
يَوْمِيّ	ADJ	daily
بَطِّيخِيّ	ADJ	low-brow
مَهَلَّبِيَّة	N	mahallabiya_(rice_pudding_topped_with_pistachios)
ماثِل	ADJ	visible
مُتَحَدِّث	N	spokesman
قَصِير	ADJ	short
شال	N	shawl
نَصْرانِيّ	ADJ	Christian
مُبَجَّل	N	revered
اِنْضَرَب	V	be_hit
طال	V	reach
مُسْتَفِيد	ADJ	benefiting
لَذِيذ	ADJ	pleasant
قالِي	ADJ	Gloss
طُهُور	N	circumcision
رَشّ	V	spray
مَلْح	N	salt
بَراءَة	N	innocence
مِجَوَّع	ADJ	famish
رِجِيم	N	diet_(Fr._rgime)
دِياوْلُو	N	Gloss
فَسَّح	V	broaden
طايِش	ADJ	rash
خارِب	ADJ	destroying
بَلاغ	N	communiqu
غَفَر	V	forgive
قَفَص	N	cage
اَوِّل	ADJ	first
مُكَيَّف	ADJ	conditioned
حَجّ	N	pilgrimage
سُعُودِي	ADJ	a_saudi
حِجّ	N	Gloss
مُتَداوَل	ADJ	circulating
خَلَع	V	take_off
أَطْهَر	ADJ	more_ritually_clean
قِبْلَة	N	qiblah_(direction_faced_in_prayer)
حَجّ	V	make_a_pilgrimage
عامْلَة	N	catastrophes
أَغْبَى	ADJ	red
سُودَة	ADJ	black
كَبْرِيتَة	N	Gloss
فَجأَة	N	suddenly
هَول	N	fright
هَدَم	V	tear_down
حَرِيق	N	fire
زَمان	N	time
تَأْبِيدَة	N	Gloss
مَناخِير	N	nose
خاتِف	N	kidnapper
مِشَرَّف	ADJ	honorable
لَبِّس	V	clothe
خَيمَة	N	tent
مَعَقَّد	ADJ	Gloss
اِخوانِي	ADJ	belonging_the_clan_of_AlixwAn
مِلاحِظ	ADJ	observer
تَوجِيه	N	directing
مُهاجْمَة	N	attacking
إِتِّهام	N	indictment
بُعْبُع	N	monster
جَبَر	V	bandage
مَحْظُور	ADJ	banned
مُتَشَدِّد	ADJ	extremist
إِنْتِظار	N	anticipating
مِتوَحِّد	ADJ	united
واعِي	ADJ	aware
وَجْهَة	N	side
عِتاب	N	censure
لَطِيف	ADJ	delicate
اِتْلَمّ	V	gather
ثابِت	ADJ	established
مُعادْلَة	N	equalizing
حِسّ	N	sensation
عَرْش	N	throne
أَوحَش	ADJ	more_awful
جَرّ	V	pull
عَمْرَة	N	Gloss
إِبْتَغَى	V	want
عَصْفُور	N	cage_bird
فَجَّر	V	blow_up
عِيار	N	gauge
اِخْتَلَط	V	be_disordered
زَفّ	V	hurry
ثَقِيل	ADJ	heavy
حَقِيبَة	N	briefcase
سَبَهْلَلَة	ADJ	Gloss
مَداح	ADJ	in_disordered_state
شاذّ	ADJ	deviant
إِسّ	N	rest
مَصُون	ADJ	preserved
أَيض	ADJ	Gloss
مِتْأَمْرِك	ADJ	Gloss
قُبَّعَة	N	hat
تِكساسِيّ	ADJ	texasian
تَهْرِيب	N	smuggling
بَلْدَة	N	township
سَمْع	N	hearing
بَصَر	N	vision
مِجامِل	ADJ	Gloss
مِشارِك	ADJ	participating
شَيِّل	V	charge_(with_responsibility)
إِحْراج	N	embarrassing
جَه	V	came
وِزارِي	ADJ	ministerial
جُزْئِي	ADJ	partial
نَقَّى	V	purify
كُفء	ADJ	qualified
تَرْمِيز	N	symbolization
اِسْتِهْتار	N	negligence
تَهْرِيج	N	jesting
مُلَوَّث	ADJ	polluted
اِمْتِصاص	N	absorption
دَغْدَغَة	N	tickling
اِسْتِدْراج	N	persuasion
أَذْكَى	ADJ	more_salty
حَرَم	V	forbid
مُبارَك	ADJ	blessed
فَخُور	ADJ	proud
دَعْوَة	N	call
إِتَّقَى	V	be_on_guard
واهِم	ADJ	wrong
مَلا	V	walk_briskly
جَمِّد	V	hardened
اِفادَة	N	benefit
حَسِّن	V	improve
مُفْجِع	ADJ	harrowing
اِحْصائِيَّة	N	a_statistic
نَسْل	N	progeny
سُكّانِيّ	ADJ	residential
دِماغِيّ	ADJ	cerebral
خِفِي	V	be_hidden
مِنْبِهِر	ADJ	Gloss
ذُهُول	N	numbness
يابانِي	ADJ	japanese
صَنَع	V	fabricate
عال	ADJ	good
مُفَضَّل	ADJ	favorite
جَذّاب	ADJ	attractive
مَشْرُوع	N	project
مُتَواصِل	ADJ	continuous
يُورُو	N	Euro
يابانِيَّة	N	Gloss
إِتّجاه	N	direction
مَشاعِر	N	feelings
قَلْبِيّ	ADJ	cardiac
أَجازَة	N	furlough
نَكَد	N	torment
خَدّامَة	N	Gloss
فُرْصَة	N	opportunity
اِسْتَحْمِل	V	bare
مَرِيض	ADJ	patient
حَمِّل	V	be_conveyed
زَيَّر	V	visit
اِسْتِفْسار	N	inquiry
عَتَق	V	be_emancipated
عَفِي	ADJ	vigorous
عَقار	N	real_estate
فَرَج	V	ease_up
تِلِيفَون	N	telephone
مِتْأَكِّل	ADJ	Gloss
أَشَّر	V	indicate
مَحِلّ	N	stores
سَيِّد	N	Sir
واجِهَة	N	facade
بَين	N	Gloss
ظاهِر	N	evident
تَقَرُّب	N	approach
أَحتِشام	N	obligation
مُنَقِّب	ADJ	driller
مُهَذَّب	ADJ	polite
مُطابِق	N	Gloss
مُعْظَم	N	most
زِينَة	N	embellishment
شُهْرَة	N	reputation
مُتَحَرِّر	ADJ	emancipated
طَرْحَة	N	headcloth
تالِت	ADJ	third
مَعْصِيَة	N	insubordination
خاتِمَة	N	conclusion
نافِع	N	useful
مَتْرُوك	ADJ	left_behind
رايِح	N	going
جايّ	N	Gloss
لَوح	N	blackboard
خَفِيف	ADJ	light
حِياد	N	neutrality
تَرْقِيم	N	numbering
بَلِيَّة	N	tribulation
فِراق	N	separation
فُراق	N	separation
جَرَح	V	wound
مُرْهَف	ADJ	thin
غَرْقان	ADJ	drowned
مُمَيَّز	ADJ	distinguished
حِلْو	N	Gloss
فالِح	ADJ	fortunate
لَفْتَة	N	turnaround
رَسْم	N	drawing
مُسِيء	ADJ	insulting
خاصِّيَّة	N	specialty
حَسّاس	ADJ	sensitive
تُحْفَة	N	gift
إِسْتَعْمَل	V	use
مِتغاظ	ADJ	annoyed
ظَرِيف	ADJ	adroit
مائِي	ADJ	aquatic
كُبْرِي	N	bridge
مِتْأَخَّر	ADJ	late
اَوِي	ADJ	very
مَبْنِي	ADJ	based
بايِخ	ADJ	annoying
كارُّو	N	Gloss
صِناعِي	ADJ	artificial
إِسْتِفادَة	N	gain
طَبِيعِيّ	ADJ	natural
سَمَكِيّ	ADJ	fish-like
شِبّاك	N	window
اِصْطاد	V	hunt
مَشْوِي	ADJ	Gloss
مَقْلِي	ADJ	fried
بَرَّق	V	shine
عُمْق	N	depth
حُلْو	ADJ	sweet
طَحْن	N	grinding
شَرَّح	V	dissect
لُولِي	N	luli
شَكّ	V	doubt
ثِبِت	V	be_firm
اِعتَنَق	V	embrace
نَفْسِيَّة	N	psychological_state
مِخَبِّي	ADJ	Gloss
بان	V	appear
ضالّ	N	erroneous
بَشْر	N	Gloss
كافِر	N	infidel
عاصِي	ADJ	rebellious
اُشاعَة	N	spreading
تَشْكِيك	N	doubt
خَلَق	V	create
إِعتِناق	N	Gloss
نُصْرَة	N	assistance
جِلْدِي	ADJ	dermal
عافَى	V	cure
كَبَر	N	grandeur
نَصْرَة	N	fragrance
مَشْهُور	N	celebrities
طُلْبَة	N	business
أَصالَة	N	authenticity
مُنْحَنِي	N	bent
بَيانِي	ADJ	explanatory
تَرْتِيب	N	arrangement
تَنازُلِي	ADJ	concessionary
مُهاب	ADJ	respected
رِجالَة	ADJ	people
لُبّ	N	core
حِكُومَة	N	Gloss
مُنَفِّذ	ADJ	executor
جِراحَة	N	surgery
مِفَكَّر	ADJ	intellectual
سَراب	N	mirage
نَوايَة	N	nucleus
حَسَنَة	N	good_deed
بِن	N	son
اِتْرَحَّم	V	bless
تَهْلِيل	N	jubilation
مُحْكَم	ADJ	reinforced
قَيِّم	V	assess
سائِغ	ADJ	palatable
تَشْدِيد	N	strengthening
فَصَل	V	separate
وَصَف	V	describe
مُناقَشَة	N	argument
زاوْيَة	N	inclination
عَقْلانِيّ	ADJ	reasonable
مُزايْدَة	N	auction
قال	N	Gloss
اِلْتَزَم	V	be_committed
فاكِر	N	thought
اِقْتِحام	N	incursion
مِتْرَتِّب	N	Gloss
رَتِّب	V	arrange
مِتْخَيِّل	ADJ	imagining
أَوسَع	ADJ	broader
وَهْلَة	N	moment
غَزْو	N	invasion
ناوِي	N	Gloss
مُهْتَمّ	ADJ	interested
مَنْظَر	N	view
الآخَر	ADJ	another
قَبِيح	ADJ	ugly
غُرُور	N	deception
اِتَّجَه	V	move
تَجْوِيع	N	starvation_(making_starve)
مُحاصَرَة	N	blockade
حِسْبَة	N	calculation
حِسْبان	N	appreciation
مُصالَحَة	N	conciliation
مَجْد	N	glory
قَومِي	ADJ	state
سِطِيحَة	N	Gloss
خَنْق	N	choking
مُدافِع	ADJ	defending
صَهْيُونِيّ	N	Zionist
طاغْيَة	N	oppressor
بِعِيد	N	Gloss
وَحْشِيَّة	N	brutality
مُجْمِل	ADJ	wholesaler
دَير	N	monastery
باهِت	ADJ	pale
مُحَرَّم	ADJ	forbidden
إِنْتِهاك	N	contravention
حَدِّث	V	tell
بايِن	ADJ	obvious
خَنْقَة	N	wrist
آَلِي	ADJ	mechanical
مِتبَنِيّ	ADJ	Gloss
غايب	ADJ	Gloss
حاقِد	ADJ	spiteful
صَوِّب	V	rectify
مُصِرّ	ADJ	determined
بِجحَة	ADJ	rude
أُزُون	N	Ozone
خاطِر	ADJ	mind
إِسْتَشْهَد	V	die_in_battle
اِنْفِجار	N	explosion
واقِع	ADJ	falling
بُعْد	N	dimension
جَنُوبِي	ADJ	southern
لِسان	N	tongue
عالَمِي	ADJ	world
مَصْدَر	N	source
مُفَرْقَع	N	Gloss
رِسالَة	N	letter
حِيادِيَّة	N	neutrality
عَزِيزِي	ADJ	pitch_pine
مِشاهْدَة	N	observation
كِشافَة	N	scouting
قَذِيفَة	N	shell
ماس	N	diamonds
كَهْرَبائِي	ADJ	electrical
حَرارَة	N	temperature
دانَة	N	dana
لَغَم	N	mine
طاب	V	be_good
عَجَل	N	hurry
اِتْوَجَّع	V	suffer_pain
مَزِّيكَة	N	music
جَبَل	N	mountain
غَيط	N	garden
شِخِير	N	snoring
رَدَح	V	dance
ثَقافِيّ	ADJ	cultural
هِباب	N	soot
مُؤاخَذَة	N	offense
جال	V	wander
جَمْرَة	N	ember
قَنْطَرَة	N	aqueduct
مَدْلُول	N	meaning
تَشْرِيح	N	dissection
سَفِينَة	N	ship
ناب	V	represent
بَهْدَلَة	N	insult
دَفْن	N	burial
كَهْف	N	cave
تَفْتِيت	N	partitioning
نَسَمَة	N	persons
صَهْيُونِيّ	ADJ	Zionist
كَرَّس	V	dedicate
مُطَّرِد	ADJ	constant
عَمِيق	ADJ	deep
سُودانِيّ	ADJ	Sudanese
جِدال	N	debate
صِبِح	V	become
تَمَرُّد	N	insurrection
عِلْمانِيّ	ADJ	secular
تَرْوِيج	N	furtherance
غِياب	N	absence
مِتْمَتَّع	N	Gloss
قِيادَة	N	leadership
قابِل	ADJ	capable
باهِظ	ADJ	oppressive
رُكُوع	N	kneeling_down
وَجَّه	V	send
تَمْزِيق	N	tearing
عَسِير	ADJ	difficult
مُتابَعَة	N	pursuit
لَهْو	N	entertainment
مَشْرُوط	ADJ	conditional
مُبَرَّر	ADJ	justified
وَحْد	ADJ	lonely
مِناهْدَة	N	Gloss
كُخَّة	N	squalor
دَحَّة	ADJ	good
كُخَّة	ADJ	bad
بِنّ	N	Gloss
اِتْنَوَّر	V	be_enlightened
كَلِيلَة	N	entirely
بَشَرِيَّة	N	humankind
ذِهاب	N	Gloss
إِنتِخابِي	ADJ	selection
تَهَوُّر	N	rashness
مُحاكْمَة	N	legal_prosecution
اِتْبَنَى	V	be_constructed
مَسْمُوع	ADJ	audible
اِحْتِفال	N	ceremony
سَخِيف	ADJ	stupid
فُرْجَة	N	pleasure
مُقاطَعَة	N	boycott
دَمَّر	V	destroy
مَجاعَة	N	famine
غِنَى	N	wealth
سَلَك	V	proceed
مَسار	N	path
نَتّاش	N	Gloss
وَدَّع	V	bid_farewell
شَوِيش	N	police_sergeant
اِسْتَسْهِل	V	select_for_easiness
نَفْي	N	denial
مُنْعَزِل	ADJ	isolated
اِتْجَمَّع	V	be_gathered
خَلَل	N	fault
كَنْز	N	treasure
حَرْبَة	N	lance
مَشْرُوع	ADJ	lawful
ذِهْنِيّ	ADJ	mental
مُحاسَبَة	N	accounting
فُرْن	N	oven
اِرْتِباك	N	involvement
حَكِّم	V	rely_on
بَذْل	N	spending
شَكَّة	N	stab
دَبُّوس	N	pin
مَكْلَمَة	N	conference
مُتَحَمِّس	ADJ	zealous
عِمْيانِي	ADJ	Gloss
مَحْقُون	ADJ	Gloss
تَحْدِيد	N	delimitation
كَمِين	N	hidden
اِتقَبِّل	V	accept
تَوافُق	N	agreement
اِتْهَيَّأ	V	be_mobilized
حَوالَيْن	N	Gloss
حِدَّة	N	intensity
مَيْدان	N	square
مَطَبّ	N	pothole
مَفْقُود	ADJ	lost
شَرْقاوِيّ	ADJ	Sharqawiya
سَيَّر	V	set_in_motion
خَنَق	V	choke
قَلَق	V	unrest
أَدَب	N	literature
مَحَطَّة	N	station
صَلَح	V	reconcile
آدَمِيّ	ADJ	human
كَلَوِي	ADJ	kidney
هِناك	N	Gloss
ذِكْرَى	N	commemoration
خالِد	ADJ	immortal
دَهْوِل	V	confuse
تَقْصِير	N	deficiency
فَضَح	V	expose
مُباشَرَة	ADJ	Gloss
ضَرْبَة	N	blow
مُمَيِّز	N	discriminating
مُكالْمَة	N	conversation
هاتِف	N	telephone
أَثار	V	raise
تَلَقِّي	N	receiving
تِلِيفَونِي	ADJ	telephone
اِطْمِئْنان	N	Gloss
جَدَل	N	controversy
مَنْشُور	ADJ	published
نَشَر	V	publish
زَعْم	N	allegation
فاد	V	benifit
عَلَّى	V	elevate
حَنْجَرَة	N	throats
صَوْتِيّ	ADJ	verbal
فَشْرَة	N	lie
لَطَف	V	be_kind
رَصِيد	N	funds
اِسْتَوَى	V	be_ripe
لُوبيايَة	N	Gloss
جَدّ	V	be_new
حَبّايَة	N	seed
اِحْتِقار	N	scorn
زَعْبُوط	N	woolen_garment
مُسْتَغِلّ	ADJ	freeloader
مُغَطَّى	ADJ	covered
عُهْدَة	N	responsibility
جَلِيل	ADJ	venerable
تَفْصِيلِي	ADJ	detailed
مَشْدُود	ADJ	tight
مِتعَقَم	ADJ	pasteurized
بُساط	N	dais
اَحْمَدِي	ADJ	Gloss
كِدا	N	this
يَهُودِيّ	ADJ	Jewish
فَطَر	V	break_apart
جَهِّز	V	become_ready
زَنْقَة	N	buildup
مِتْشَعْبَط	ADJ	Gloss
فَرَّح	V	gladden
حَجَز	V	retain
مُعاصِر	ADJ	contemporary
بات	V	become
سَنَد	V	support
مُعاناه	N	Gloss
مَسْؤُل	ADJ	dependable
رَغَى	V	chatter
مَقْدِرَة	N	ability
طالِع	ADJ	rising
سَوَّى	V	equalize
مُتَوَقِّع	N	expected
بِهِيم	N	domestic_animal
فَضَل	N	favor
شُغْلَة	N	position
بُنّ	N	coffee_beans
سايِح	ADJ	tourist
مايَة	N	water
مَقْلَب	N	dumping_ground
إِنْتَهَى	V	be_concluded
عَدَسَة	N	lens
إِتْكَلِّم	V	talk
اِضافِي	ADJ	additional
مُرَفَّه	ADJ	living_in_luxury
اِتْوَزَّع	V	be_distributed
غَنِي	ADJ	richest
أَلَدّ	ADJ	implacable
مِتبَهدِل	ADJ	mistreated
سَقا	V	water[verb]
مَجْرَى	N	course
مُفْزَع	ADJ	frightened
حابِب	ADJ	liking
عَقَّب	V	criticize
أَكْل	N	eating
عِين	N	eye
مِجارِي	N	Gloss
ساإِل	ADJ	Gloss
مُؤْذِي	N	harmful
هَلاك	N	disaster
تِلِف	V	waste_away
مُعايَشَة	N	coexistence
غَمْر	N	flooding
وَظِيفَة	N	job
سَمَكَة	N	Pisces
تِرْعَة	N	channel
بُلْطِي	N	nile_tilapia
شِلِن	N	shilling
نَزِّل	V	make_descend
خُضار	N	greens
مَرْشُوش	ADJ	splattered
نِسْبَة	N	ratio
مُتَعَلِم	ADJ	educated
شُغْلانَة	N	work
عِلْم	N	knowledge
سِهِر	V	stay_up_the_night
اِتْحَدا	V	be_shod
خَلَط	V	mix
جَهِل	ADJ	poor
مُنْحاز	ADJ	aligned
أَمَر	V	command
جاهِل	N	ignorant
شَقَى	V	Gloss
مِجَرَّب	ADJ	tester
مُقَدَّر	ADJ	estimated
كَتَم	V	conceal
آخِرَة	N	hereafter
اِتْعَذِّب	V	torture
خُلاصَة	N	gist
مِصْرِيّ	N	Egyptian
كَون	N	being
أُورُبِّي	ADJ	European
مُمَرِّضَة	N	nurse
تَمَن	N	Gloss
مَأْمُورِيَّة	N	Gloss
مِنْتِشِر	ADJ	Gloss
مَكْشُوف	ADJ	open-air
اِغْتِصاب	N	rape
خَطْف	N	hijacking
فِلِت	V	escape
هَمَجِي	ADJ	disturbance
تَرْبِيَّة	N	education
عُذْر	N	excuse
ضِعْف	N	double
قِرايَة	N	Gloss
قُدْسِي	ADJ	sacred
طاعَة	N	obedience
صَوم	N	fasting
اِزْدِهار	N	prosperity
دُنْيَوِيّ	ADJ	worldly
غِلِب	V	ovecome
قُرآن	N	Gloss
خِفْيَة	N	Gloss
دَقَّق	V	be_precise
رَكَز	V	set_up
مِتْرَتِّب	ADJ	Gloss
بِتَع	N	property
مِتْخَطَّط	ADJ	planned
غابَة	N	forest
أَعْوان	N	aids
مِدَلَّع	ADJ	Gloss
صَدَف	V	avoid
نَيِّم	V	lay_down
عَوَض	N	substitute
حاسّ	ADJ	Gloss
هَنا	N	good_health
رَخاء	N	comfort
لاعِب	N	player
جَخّ	N	wealth
ذاكْرَة	N	memory
دَبَّر	V	make_plans
كَيد	N	stratagem
نَزَف	V	drain
مَفَرّ	N	escape
زائِد	N	additional
عَبْط	N	dying_prematurely
وَصَى	V	Gloss
دَنِيء	ADJ	contemptible
حَفِظ	V	preserve
رَبَّى	V	raise
شَغّالَة	ADJ	maid
مُلُوتَوف	N	Gloss
مُهَبَّب	ADJ	sooty
قِلِّيَّة	N	entirety
دَبَّة	N	sand_hill
صافِي	ADJ	pure
أَغْلَب	N	most_(of)
عَنَد	V	be_stubborn
خِناقَة	N	quarrel
والِع	ADJ	burning
مِيَّة	N	hundred
جَرا	V	happen
رُخامَة	N	marble_slab
حَجْر	N	restriction
مُتَعاطِف	ADJ	sympathizing
بادِئ	ADJ	beginning
مَبْنَى	N	building
سَفالَة	N	lowness
داهْيَة	N	Gloss
طالِب	ADJ	requesting
مالِيّ	ADJ	financial
اَسْوانِي	ADJ	Gloss
سال	V	flow
تَحْكِيم	N	arbitration
اِتْعاطِف	V	sympathize
يِه	N	him
مُمَوَّل	ADJ	financed
بُطْلان	N	nullity
مِقَعَّد	ADJ	making_one_sit
لَطْم	N	Gloss
نَرْفِز	V	irritate
عَيِّن	V	keep
هِمِد	V	be_calm
اِتْرَمَى	V	throw
إِمْتَى	ADJ	Gloss
اِتْعَدَم	V	be_hanged
أُسْتاذ	N	professor
جَحْد	N	denial
بالِغ	ADJ	extreme
هَنْدَسَة	N	engineering
عُضْوِيَّة	N	membership
فَلَتان	N	chaos
عِياط	N	screaming
جَزَى	V	reward
قَيِّم	ADJ	valuable
بَكَى	V	cry
تَشَفِّي	N	gratification
خال	N	maternal_uncle
كُور	N	furnace
حَدَف	V	be_thrown
وَطَّى	V	lower
كاتِم	ADJ	silencer
تَهْدِئَة	N	calming
نادِر	ADJ	rare
جِيتار	N	guitar
صاعِقَة	N	lightning
غار	V	penetrate
اِتْقَتَل	V	be_killed
صايِع	N	vagabond
بُقّ	N	mouth
مُفْتِي	ADJ	mufti_(Muslim_legal_scholar)
سَهْران	ADJ	awake
مِستَغنِي	ADJ	Gloss
اِنْتِباه	N	vigilance
حُدُودِيّ	ADJ	frontier
اِطْفاء	N	extinguishing
كَمِيل	ADJ	Gloss
ضِمْنِي	ADJ	tacit
جَبَرُوت	N	omnipotence
زِيارَة	N	visiting
مُتَبَقِّي	ADJ	residue
حِرْص	N	desire
مَدَنِيّ	ADJ	civilian
مُتَخاذِل	ADJ	weak
راضِي	ADJ	pleased
مَرْمَطَة	N	Gloss
اِتْنَفَخ	V	swell
العُذْرِيَّة	N	chastity
بَلَع	V	swallow
شَوكَة	N	fork
اِطَّمِن	V	be_confident
عِشْق	N	love
مَسْمُوح	ADJ	permissible
مُجَنَّد	N	recruit
زَنّ	V	drone
لِوا	N	banner
عَبّاسِيّ	N	Abbasid
رَطَّب	V	moisten
نَزَع	V	remove
سَدِّد	V	fulfill
فِطارِي	ADJ	Gloss
صايِم	ADJ	fasting
فَخّ	N	trap
نَجَّح	V	make_successful
هُوبَة	N	Houba
طَيُّوب	ADJ	kind
مُعَبَّر	ADJ	expressed
صَفْقَة	N	deal
كَرْب	N	worry
بِسْكِلِتَّة	N	bicycle
مَفسِيّ	ADJ	flat
مُصَمِّم	N	designer
مُخْلِص	ADJ	sincere
راعَى	V	observe
مِهاوِد	ADJ	true
خَرَّف	V	be_senile
كِدْبَة	N	lies
لَحُوح	ADJ	obstinate
كِبَر	N	grandeur
مُتَّهَم	N	accused
مَقالَة	N	column
ساخِر	ADJ	joker
مُرِيب	ADJ	suspicious
اِتْقال	V	be_told
وَحْل	N	mud
قَمَر	ADJ	mon
حَبْل	N	cord
مِشْنَقَة	N	gallows
مُتَسَلِّط	ADJ	authoritative
سانِح	ADJ	auspicious
بَدِيل	N	substitute
مُتَجَسِّد	ADJ	corporeal
راشِد	ADJ	adult
فَوَّق	V	wake_up
مِغَمِّي	ADJ	closing
غاب	V	be_absent
نَهْرِي	ADJ	river
أَسَد	N	lion
شَجِيع	ADJ	brave
سِيما	N	sign
حُقُوقِيّ	ADJ	juristical
تَرْخِيص	N	granting_of_permission
رَفِيع	ADJ	high-ranking
اِتْدَرَّب	V	take_training
مُرَخَّص	ADJ	licensed
هاجِم	V	be_attacked
أَحال	V	refer
شَخَط	V	shout
كُرْباج	N	whip
اِسْتِئْناف	N	appeal
عَظَّم	V	glorify
أَجْر	N	remuneration
بَيِّن	V	declare
قاضِي	N	judge
نَظَر	V	look
جَرْح	N	wound
كِبْرِياء	N	arrogance
والِد	N	father
هَزْلِيّ	ADJ	comical
تَلْقِيح	N	inoculation
تَعْرِيض	N	exposure
مُعارِض	N	opponent
هُزال	N	emaciation
مَدَوِيّ	ADJ	cutler
خَجَل	N	shame
سَيِّدَة	N	lady
مَرَج	N	confusion
دابِق	ADJ	Gloss
مِحَمِّي	ADJ	Gloss
صَرْصُور	N	cockroach
تَسْلِيح	N	arming
تَفاوُض	N	negotiation
صُدُور	N	appearance
مُخّ	N	brain
نَجْم	N	star
جَوِّيّ	ADJ	air
سُوء	ADJ	Gloss
اِنْتَصَر	V	win
رَكَع	V	kneel
أَفْرَج	V	release
مُساوَمَة	N	bargaining
قَرَص	V	pinch
دان	V	condemn
اِتبَهَى	V	pamper
لَزَق	V	stick
مَسِيرَة	N	march
هِتاف	N	shouts
دْوَى	V	Gloss
مِتخَيَّط	ADJ	stitched
بايِت	ADJ	sleeping
مُطَّلِع	ADJ	well-informed
ظالِم	N	oppressor
مَظْلُوم	N	victim_of_oppression_or_injustice
أَنْف	N	nose
صَلّ	V	Gloss
دَخلِيَّة	ADJ	interior
مُنشاءَة	N	building
صَحِيح	N	Gloss
هِوّ	N	space
لَئِيم	ADJ	depraved
مِقَطَّع	ADJ	Gloss
تَبَنِّي	N	adoption
بِنَيَّة	N	young_girls
اِنْضِمام	N	seam
مِين	N	lie
جِنّ	N	demon
حِرمانِيَّة	N	missing
رَكْعَة	N	kneeling_down
اِتْعَوِّد	V	be_accustomed
وَحِّد	V	delimit
مُماثِل	ADJ	similar
مُعَرِّب	ADJ	declaring
اِنْتِفاضَة	N	rising
مُخاطِب	ADJ	Gloss
سَلْب	N	robbing
مُقاطْعَة	N	boycott
حاشِد	ADJ	crowded
اِنْهاء	N	termination
اِنساق	V	follow
سَخَّن	V	heat
زَقّ	V	feed_(mouth-to-mouth)
فَضَّى	V	vacate
لاعِب	ADJ	playing
مَسلُوب	ADJ	deprived
بارِحَة	N	yesterday
تَسْخِين	N	heating
مَخْلُوع	ADJ	deposed
مُلَطَّخ	ADJ	stained
مُصاب	N	afflicted
تَرْقِيَة	N	promotion
بَطِيء	ADJ	slow
بَرْد	N	cold
شَتَى	V	Gloss
اِتْفَرَج	V	be_opened
شاعِر	N	poet
اِنتَشَر	V	spread
صامِت	ADJ	silent
مَرْبُوط	ADJ	tied
ساوَى	V	settle
تَنازُل	N	concession
سَكَن	N	housing
مُقَدِّمَة	N	preface
خُبْث	N	malice
تَغْلِيف	N	wrapping
جاهِز	ADJ	prepared
مِسَمِّي	ADJ	Gloss
قاتِل	ADJ	deadly
تَشْجِيع	N	encouragement
حَقُود	ADJ	spiteful
شَغَب	N	unrest
وَطَن	N	nation
تَخْفِيف	N	decrease
حُزن	N	sadness
غَرْبِيّ	N	west
مُحافْظَة	N	governorate
عَلِم	V	know
طُرَّة	N	forelock
تَرْك	N	leaving
مِتلَزَّق	ADJ	stuck
بَذِيء	ADJ	disgusting
شُبْهَة	N	obscurity
خَوِّف	V	make_them_afraid
اِكْتَأَب	V	become_ill
مَدْبُوح	ADJ	slaughtered
شاوِر	V	show
اِحْتَفَل	V	celebrate
وَهْمِيّ	ADJ	imagined
بَوَّخ	V	spoil
شَفّ	V	be_thin
رَسْت	N	Gloss
مُؤْلِم	ADJ	painful
أِنتِخاب	N	elections
ناشِط	N	activist
نَوّارَة	N	Gloss
جَراج	N	garage
صَحَفِيّ	N	journalist
مُؤامَرَة	N	plot
فَرّازَة	N	separator
عُرْضَة	N	target
ضَحْل	ADJ	shallow
عَقَد	V	hold
اِسْتَدْعَى	V	summon
لَفْظِيّ	ADJ	literal
غَزِير	ADJ	abundant
ضَرَّب	V	quilt
صايِع	ADJ	trivial
زَمّار	N	piper
هَجَم	V	attack
عَلَقَة	N	coagulated
بَلاطَة	N	floor_tile
تَجْنِيد	N	recruitment
تَجنِيدِيّ	ADJ	recruitment
فُكاهَة	N	joking
مَرْكَزِيّ	ADJ	central
دَرَّب	V	habituate
صِعِيد	N	upper_egypt
ضَبْطِيّ	ADJ	disciplinary
مِجَنِّد	N	Gloss
نَدَه	V	urge_on
مِتدَرَّب	ADJ	trained
نادِه	ADJ	Gloss
مِدِّي	ADJ	Gloss
نَطّ	V	jump
لَخْبَط	V	disorganize
عَسْكَرِيّ	ADJ	military
أَسْمَى	ADJ	higher
صَنِيَّة	N	plate
مِتْلَخْبَط	ADJ	Gloss
حِرِّيف	ADJ	spicy
اِسْتَلَم	V	receive
قَسِّم	V	divide
حَرْفَنَة	N	skill
قَسَم	V	divide
حِلْفان	N	oath
مِلَوِّن	ADJ	colored
دِيب	N	wolf
مَشِيئَة	N	will
رَصْد	N	observation
اِتهَنّا	V	be_in_peace
شَلَل	N	paralysis
غَضبان	ADJ	angry
ثايِر	ADJ	revolting
مُرْشِد	N	guide
طَنْط	N	aunt
لَمْبَة	N	lamp
مَطفِيّ	ADJ	shut_down
شَطُّورَة	N	maher
جُوهَرَة	N	jewel
نَقِيّ	ADJ	pure
عَفِيف	ADJ	virtuous
غَرام	N	infatuation
مَليُونِيَّة	N	millinium
رَنَّة	N	ringing
لَمَح	V	glance
قاوِم	V	oppose
نَوَى	V	intend
آمِن	ADJ	secure
جَنِّب	V	help_avoid
غَلَّى	V	boil
عِلّان	N	assonant_complement_filan
اِنْسَحَب	V	retire
اِتْثَقَّف	V	cultivate
خَرَّب	V	destroy
مَسِيحِيّ	ADJ	Christian
فَكِّك	V	dismantle
واجِع	ADJ	Gloss
سَلْخ	N	skinning
اِتْسَلَّى	V	entertain
تَوكَة	N	tie
تَمِّم	V	complete
مُغَيَّب	ADJ	hidden
اِتْفائِل	V	be_optimistic
حُمَّى	N	fever
اِتْحَرَّر	V	be_free
صَحَّح	V	correct
كَيان	N	entity
حامِي	N	protector
تاجِر	V	do_business
سَفَّر	V	unveil
مُشْفِق	ADJ	compassionate
اِمْتِنان	N	gratefulness
مَلّ	V	become_bored_with
مُناضِل	ADJ	fighting
سَبِّن	V	become_full_of_nits
فَرَّج	V	open
رُتْبَة	N	level
باض	V	lay_an_egg
دَهَب	N	gold
عَجِيبَة	N	marvel
غُنا	N	singing
مَسحُول	ADJ	naked
بِرِد	V	be_cold
حَما	N	heat
كَرَم	V	venerate
وَهَب	V	donate
دَبّابَة	N	tank
أَجْبَر	V	force
مُعْلَن	ADJ	declared
فِئَوِيّ	ADJ	factional
شَلّ	V	paralyze
مِتْحَدِّد	ADJ	set
اِرْضاء	N	satisfaction
دَمَوِيّ	ADJ	bloody
مُعَزَّز	ADJ	Gloss
مُكَرَّم	ADJ	honored
نِجْم	N	star
نِيابَة	N	proxy
أَقْذَر	ADJ	Gloss
ثَوْرِي	N	revolutionary
تَعالَى	V	be_raised
اِسْتِدْعاء	N	petition
شَرِيف	ADJ	noble
حَماسَة	N	bravery
مِتَنِّك	ADJ	relaxing
عَسُّول	ADJ	honey
سِنّ	N	tooth
تَقْسِيط	N	payment_in_installments
مِتْسَتِّت	ADJ	coquettish
مَنْدُوب	N	delegate
مَبِيع	N	sales
لَمُونَة	N	lemon
عِمالَة	N	employment
أَثِم	V	do_wrong
قَران	N	connection
شِتِيمَة	N	invectives
حَسبَنَة	N	Gloss
بَرِيء	ADJ	innocent
اِتْلَعَب	V	be_played
أَبْعَد	V	remove
اِتْصاب	V	strike
قُنْبِلَة	N	Gloss
تَوأَم	N	twin
فاض	V	exceed
صَبُور	ADJ	cheese
اِقتَرَب	V	approach
شَعْبِيّ	ADJ	popular
بَعِيد	ADJ	remote
اِنْضَمّ	V	join
رُؤْيَة	N	vision
اِرْهاق	N	pressure
مُتعَب	ADJ	tired
هَتَف	V	call
أَنْشَد	V	seek
اِنْصِراف	N	departure
تُرْكِي	ADJ	Turkish
دُكّان	N	shop
اِسْتَقْبَل	V	be_welcome
مِيتَة	N	death
مُبرَح	ADJ	painful
كَتِيبَة	N	brigade
حاجِز	N	obstacle
مُحْبِط	ADJ	fruitless
مِتْرَبِّي	ADJ	educator
مُحارِب	ADJ	fighting
وَهْمِي	ADJ	imagined
نَقْض	N	contradiction
سالِم	ADJ	secure
غانِم	ADJ	gainer
مُشَرِّف	ADJ	honorable
بالَون	N	Gloss
تَعْرِيَة	N	uncovering
رَحَل	V	depart
اِمْتَحَن	V	sit_for_an_exam
طَرَح	V	submit
ناقِل	ADJ	transmitting
اِتْفَصَل	V	classify
حَرَّم	V	outlaw
اِسْتَأْذِن	V	Gloss
نِزُول	N	descent
تَنَعَّم	V	live_in_luxury
باِيت	ADJ	sleeping
مُعْتَقَل	ADJ	detained
شارِك	V	participate_with
حاكِم	V	judge
اِسْتَشْهَد	V	seek_a_witness
مَدْهُوس	ADJ	Gloss
نَضَّف	V	clean
اِنْطَفَى	V	be_calmed_down
يُوماتِي	N	Gloss
مُحْتَفِظ	ADJ	keeping
رايَة	N	banner
جِيل	N	generation
مَهْزُوم	ADJ	defeated
سِرِير	N	bed
اِعتَرَف	V	confess
كادِر	N	cadre
مِغَطِّي	ADJ	Gloss
ضِلّ	N	patronage
يِأِس	V	become_hopeless
ظابِط	ADJ	controller
نِصِيبَة	N	accident
خَزَق	V	pierce
شَعْلِل	V	set_fire_to
مُشَرَّد	ADJ	homeless
نَسَب	V	relate
فَتُوكَة	N	young_girls
سَلَفِيّ	N	Salafi
أَولَى	V	devote
مُخالِف	ADJ	divergent
تَسْطِيح	N	leveling
شِفاء	N	cure
عِلميانِيّ	ADJ	secular
تَقْسِيم	N	partition
باطِن	N	inside
مُعْتَمِد	ADJ	employing
رِبْح	N	profit
اِفتَرَى	V	be_dishonest
مَثابَة	N	virtually
تَخْوِين	N	Gloss
مِحْتار	ADJ	be_confused
لَجَأ	V	resort
آدَم	N	human_beings
رَبَط	V	tie
حَرام	ADJ	sacred
مُتَطَوِّع	ADJ	volunteer
مُسْتَوْرَد	ADJ	imported
مَكْتُوب	ADJ	written
مَرَح	N	happiness
نَبَح	V	bark
فَقْع	N	Gloss
وَجْه	N	face
حَيَوِيّ	ADJ	vital
قَفْل	N	Gloss
نَفِيس	ADJ	precious
مِوَقَّف	ADJ	stopping
مِحاسْبَة	N	accounting
اَقَلِّيَّة	N	minority
نَشِط	ADJ	active
بَيبِي	N	baby
مُسِنّ	ADJ	aged
خِناق	N	noose
تَرْيَقَة	N	Gloss
مِتقَسِّم	ADJ	divided
اِتْنَسَى	V	be_forgotten
تَراكُم	N	accumulation
عُسْر	N	difficulty
مِبَدِّل	ADJ	Gloss
غُمَّة	N	anxiety
قَيُّوم	N	everlasting
رَوَى	V	tell
طَفَّى	V	extinguish
قايِد	ADJ	burning
بَوْصَلَة	N	compass
ناخِب	N	voter
طَشاش	N	weak
طَناش	N	indifference
مَوقِع	N	position
تَوكِيل	N	appointing_(representative)
خان	V	betray
عَزَل	V	depose
بَشَّر	V	augur
عَلّ	V	Gloss
مُكَوَّن	ADJ	composed_of
ناجِح	ADJ	successful
مُدَرِّب	N	trainer
شِيطان	N	devil
لَوم	N	blame
اِستراتِيجِيّ	ADJ	strategic
اِنْبَسَط	V	be_flattened
مُعالَجَة	N	treatment
بَطَّن	V	cover
وَزَرَة	N	baseboard
بَرْطَع	V	gallop
تاي	ADJ	Gloss
عَبَط	N	folishness
اَفقَد	V	miss
فَتَى	V	give_legal_opinion
نَزِيف	N	bleeding
جَلْطَة	N	raw_place_crape
وَفاه	N	death
تَهَيُّج	N	disturbance
جِلْد	N	skin
رَطْب	ADJ	fresh
عَمَى	N	blindness
سُعال	N	cough
تَنَفُّس	N	respiration
ذُعْر	N	fright
فَورِي	ADJ	on_the_spot
مُسَرطِن	ADJ	causing_cancer
تَعَرُّض	N	being_exposed_to
تَهْوِيَة	N	ventilation
جُرْعَة	N	dosage
رِئَوِيّ	ADJ	pulmonary
مُلَطَّف	ADJ	kinder
غُسْل	N	washing
دَوا	N	remedy
نارِيّ	ADJ	fire
مُسَمِّم	ADJ	poisoning
اِلْتَفّ	V	be_wrapped
مَكْسُور	ADJ	broken
طِفْلَة	N	baby_girl
اِصابَة	N	injuries
رُكْبَة	N	knee
حُقّ	N	small_container
هَرَب	V	flee
بَقَّل	V	Gloss
نِجِس	ADJ	filthy
فاجِر	N	immoral
نَجِس	N	incurable
مُبِيد	ADJ	destructive
قَولَون	N	bowels
أَهْبَل	ADJ	dim-witted
مُراقَب	ADJ	being_watched
مِتْقَيِّم	ADJ	Gloss
خَلْفِيَّة	N	background
مُسَيْطِر	ADJ	ruling
مِتْظاهِر	N	Gloss
خَزِينَة	N	treasury
مِساعِد	N	Gloss
هَدِّد	V	threaten
عَزْل	N	removal
مَأجُور	N	salaried
مُؤامْرَة	N	conspiracy
طَمْعان	ADJ	Gloss
اِنْسَخّ	V	copy
مِتعَجِّل	ADJ	be_in_a_hurry
مُحَرِّك	N	motor
اِتْفاجِئ	V	be_surprised
باشا	N	pasha
مُنْهار	ADJ	suffering_a_breakdown
مُوتُوسِيكل	N	motorcycle
دَبُّورَة	N	Gloss
كاب	N	cape
اِتْثَبِّت	V	fix_tightly
صِينِيَّة	N	porcelain
اِسْتَهْلِك	V	be_hurled_down
خَلْصان	ADJ	Gloss
مُذْهِل	ADJ	amazing
سَعادَة	N	happiness
مُقْتَبَل	N	prime
شَلّال	N	falls
صُوِيت	N	shouting
نُوفِمْبِر	N	November
فَقَع	V	burst
هَيمَنَة	N	surveillance
قِدْرَة	N	jug
أَجْدَع	ADJ	nobler
مُغْمَى	ADJ	fainted
مَسَح	V	wipe_off
مِتْضايِق	ADJ	Gloss
قَرْفان	ADJ	disgusted
جَمْهَرَة	N	gathering
مُنَظَّمَة	ADJ	Gloss
عَشْوائِيّ	ADJ	random
عايِز	N	Gloss
عَجِين	N	dough
ساح	V	travel
اِتْحَمِّل	V	assume
اُسْطُول	N	fleet
جَدارَة	N	worthiness
مَعاش	N	salary
اِجْتِهاد	N	reinterpretation_of_the_Koran_(in_light_of_changing_circumstances)
أَسْوَد	ADJ	brown
مُسَلَّم	ADJ	granted
هَوجَة	N	involvement
خارجِيَّة	N	ministry_of_foreign_affairs
لِيبِرالِيّ	ADJ	liberal
اِنْهِيار	N	breakdown
ناهِب	ADJ	looter
زَوال	N	disappearance
حُكْم	N	judgment
عَكّ	V	be_sultry
كَنَس	V	sweep
رِسِي	V	come_out
دَهْر	N	fate
مُغْتَرِب	N	expatriate
بِضاعَة	N	merchandise
رَغّاي	ADJ	talkative
اِمْكان	N	possibility
بَرْفان	N	perfume
تَجْمِيل	N	embellishment
عامَّة	N	general_public
عَبايَة	N	cloak
شِياكَة	N	elegance
اِسْتِهْلاكِي	ADJ	consumer
اِنتِعاشَة	N	revival
زارِر	ADJ	Gloss
بُنا	N	constructing
مِستَخسَر	ADJ	reluctant
خامَة	N	raw_materials
كاش	N	criticism
خَبِيث	ADJ	malicious
صِينِي	ADJ	Chinese
عِلْو	N	Gloss
تَنْوِيم	N	anesthetization
مَغْناطِيسِي	ADJ	Gloss
اِتْمَنَع	V	forbidden
مِدَّن	N	Gloss
سِباحَة	N	swimming
مايَوه	N	Gloss
اِبْتِدائِيَّة	N	Gloss
رُكْن	N	foundation
وَلَّى	V	put_in_charge
تَوِّب	V	make_repent
سَمَع	N	hearing
نادِي	N	club
مُتَخَوِّف	ADJ	Gloss
جُزَيء	N	molecule
كُلِّي	ADJ	general_anaesthetic
مُنتَقِبَة	N	veiled_woman
أَيّ	ADJ	any
مُدِيرِيَّة	N	administration
اِتْقَفَل	V	be_locked
عاجِل	ADJ	urgent
مِتْحِفِظ	ADJ	preserved
مِقَرَّب	ADJ	close_companion
حَدَث	N	incident
إِضرَب	V	bit
مَسْجُون	ADJ	imprisoned
مَخْنُوق	ADJ	strangled
مُشَجِّع	N	supporter
عُرْيان	ADJ	naked
شَيْطانِيّ	ADJ	satanic
مَفْلُوق	ADJ	Gloss
اِعْتَقَل	V	arrest
لَقَّن	V	teach
باص	N	bus
نُسْخَة	N	copy
مَحْسُوب	ADJ	calculated
قايِل	ADJ	saying
مِغَمِّس	ADJ	Gloss
مُحامِي	N	lawyer
إِتحَرَّك	V	get_moving
مُطْرِب	N	musician
مِسَمِّم	ADJ	Gloss
مِتْكَسَّر	ADJ	Gloss
مَغْلُوب	N	loser
غُرُوب	N	setting
اِنْتِقام	N	reprisal
شاهِد	V	witness
قِيل	N	remark
هَدّاف	N	sharpshooter
نَفَى	V	deny
جُرْنال	N	journal
مُنْزَعِج	ADJ	angry
قاصِد	ADJ	direct
بَدَّى	V	Gloss
بايِظ	ADJ	corrupt
دَرْدَشَة	N	chat
بَحْت	ADJ	pure
طائِفِي	ADJ	factional
نَغَمَة	N	tune
تُخْمَة	N	repletion
نُخْبَة	N	elite
عَدِّل	V	change
اِسلامِي	N	Islamic
مِتْفَصَّل	ADJ	established_facts
مُتَجَرِّد	N	impartial
صِياغَة	N	drafting
اُفُق	N	horizon
مَحْو	N	eradication
حاصِل	N	holder
اِتْوافِق	V	agree
أَذِّن	V	call_pray
اِنْجِلِيزِي	N	English
عِلْمانِي	ADJ	secular
لابِد	ADJ	Gloss
لَهْجَة	N	tone
اِستِعلائِي	ADJ	exalted
مُستَفِذّ	ADJ	Provocative
مُتَطَرِّف	ADJ	extremist
مُنافِق	ADJ	hypocrite
جارِح	ADJ	injuring
اِسْتَغْفَر	V	ask_god_for_forgiveness
مِتْدَيِّن	ADJ	pious
شَرِيعَة	N	Sharia_(Islamic_law)
نَدْمان	ADJ	repentant
فَوْرِيّ	ADJ	immediate
غَيب	N	invisible
تَنْوِيه	N	allusion
عاجِب	N	pleasing
مُتَزَمِّت	ADJ	prim
جامِع	ADJ	comprehensive
سَلَفِيّ	ADJ	Salafi
خَشّاب	N	Gloss
مُبَرِّر	ADJ	justifying
إِخْوانْجِي	N	Gloss
إِلِيكْتِرُونِيّ	ADJ	electronic
اِتْفَهَم	V	be_heard
نَيّ	ADJ	fat
إِخوانجِي	ADJ	Ikhwany
مُنْتِج	ADJ	productive
مُتَحَكِّم	ADJ	controlling
تَدْرِيج	N	gradation
أَلْهَم	V	inspire
تَسْلِيمَة	N	handing_over
تَثْبِيت	N	substantiation
اِكْتِساح	N	seizure
مُكْتَسِح	ADJ	Gloss
شَعْبِيَّة	N	popularity
نِسائِيّ	ADJ	feminist
تَحالُف	N	alliance
بَهِيّ	ADJ	beautiful
شابَّة	ADJ	young
مُتَوَجِّه	ADJ	going_towards
مِظَلَّة	N	umbrella
وِلايَة	N	state
زَهِيد	ADJ	moderate
اِتِّخاذ	N	Gloss
اِنْهِزامِي	ADJ	defeatist
نَفسَوِي	ADJ	psychological
اِتْعَدَل	V	be_steady
واجِب	ADJ	necessary
غَيْران	ADJ	jealous
طَبّاخ	N	cook
أَفْغانِي	ADJ	Afghan
جَرِيء	ADJ	bold
إِنْتِقام	N	reprisal
تَدْنِيس	N	pollution
اِلْتَحَق	V	enroll
آرِيّ	ADJ	Aryan
نَقِي	ADJ	pure
فُولكلُورِيّ	ADJ	folkloric
سُوفيِتِّي	ADJ	Gloss
قُرآنِي	N	Gloss
مُؤْمِن	N	believer
وَرَد	V	appear
سَنَّة	N	Gloss
شَرْع	ADJ	legal
سِياسَة	ADJ	politics
يَهُودِي	ADJ	Jews
مُحَرَّف	ADJ	distorted
نَبَوِيّ	ADJ	prophetic
إِنقِطاع	N	discontinuation
حَضّانَة	N	incubator
وِلِد	V	give_birth_to
عاوِن	V	be_supported
اِتْقابِل	V	meet_face_face
مَحْكَمَة	N	court
فِشِنْك	ADJ	forged
اِعْتَذَر	V	allege_a_pretext
طاخ	N	Gloss
شَكِّك	V	give_suspicions
أَطْعَم	V	feed
زِبُون	N	fierce
حامِل	ADJ	bearing
شَعْوَذَة	N	sleight_of_hand
دُخّان	N	smoke
إِكتِئاب	N	depression
عَلَن	ADJ	Gloss
الإِستِيراتِيجِيّ	ADJ	strategic
زَفَّة	N	procession
حِراسَة	N	guard
مُرَشَّح	ADJ	nominated
حِفْنَة	N	handful
إِحتَجَز	V	reserve
أَنْفَع	ADJ	most_useful
الأَرشَد	ADJ	wiser
جاء	V	arrive
وَهْم	N	delusion
مُتَفَلْسِف	N	would-be_philosopher
فَلْسَفَة	N	philosophy
نَدْب	N	assignment
دُون	ADJ	poor
مَشْبُوه	ADJ	suspected
إِسرائِلَيّ	ADJ	Isreali
إِنتَظار	N	waiting
مَلَأ	V	fill_up
ثار	V	revolt
إِنْسَحَب	V	pull_out
أَيَّد	V	support
إِنْبَطَح	V	be_floored
تَجَرَّأ	V	dare
مَغْلُوط	ADJ	false
غَلْوَشَة	N	Gloss
اِقْلِيم	N	region
أَفا	N	reverse
اِتْحَلّ	V	be_dissolved
مِكَفِّي	ADJ	competent
عَدْل	ADJ	rectify
اِسْتِراحَة	N	rest_rom
تَكْفِير	N	atonement
اِرْتِجاج	N	concussion
مِخَلَّص	ADJ	skilful
أَحْسَن	ADJ	better
سَكِّت	V	mute
صُعُوبَة	N	difficulty
نِتّ	ADJ	splendid
اِنْعَزَل	V	be_separate
أَهْدَر	V	abandon
سَلْطَنَة	N	sultanate
مَحْبُوس	ADJ	imprisoned
طائِر	N	bird
اَرحَم	ADJ	most_merciful
خِلافِيّ	ADJ	controversial
والْدَة	N	mother
ساخِن	ADJ	hot
ضِمْن	N	within
مالْها	N	Gloss
اِسْتَهْجَن	V	disapprove
اِتْقان	N	mastery
ضَلال	N	error
عَلِيم	N	specialist
إِصْلاح	N	reform
قاطِع	ADJ	decisive
مُؤْسِف	ADJ	regrettable
مُخْزِي	ADJ	disgraceful
حَضانَة	N	Gloss
كَحْكَة	N	a_cokie
أَحْمَر	ADJ	red
اِنْجلِيزِي	N	Gloss
مُتَناقِض	ADJ	contradictory
اِعْتِدال	N	moderateness
قائِم	ADJ	ongoing
اِسْتَشْعَر	V	experience_the_sensation
اِتِّهام	N	indictment
شَفَى	V	cure
مُسَلِّي	ADJ	entertaining
جَوِّي	ADJ	aerial
شِمال	ADJ	left
طَبْلَة	N	drum
رِقّ	N	slavery
نِجِح	V	succeed
هَرْجَلَة	N	chaos
اِتْلَغَى	V	be_canceled
مِكَسَّر	ADJ	fragmented
مُحْتَجَز	ADJ	detained
طابُونَة	N	oven
زاع	V	broadcast
اِسْتِعْراض	N	review
اِتْعاطَى	V	be_involved_with
مُسْتَعْمَل	ADJ	used
إِساءَة	N	insult
لِباس	N	clothing
أَجاب	V	answer
عامِّيّ	ADJ	popular
مايِل	ADJ	inclined
سُنَّة	N	customary_procedure
مَكْرُوه	ADJ	detested
دُنْيَوِي	ADJ	Gloss
يُسْر	N	ease
مُسْتَحَبّ	ADJ	desirable
مُباح	ADJ	true
حِشْمَة	N	shyness
كَبَّر	V	magnify
فِتِوَّة	N	adolescence
الدَخلِيَّة	N	of_state
مُنَوِّه	ADJ	alluding
عَدَل	V	act_justly
اِتْوَقَف	V	be_stopped
مُلْتَحِي	ADJ	beard
مُتَحَدِّث	ADJ	spokesman
أُسْوَة	N	model
هِناك	ADJ	Gloss
شاسِع	ADJ	wide
أَدان	V	condemn
رادِع	ADJ	deterring
مِتابْعَة	N	pursuit
سَبَق	V	precede
مَخْلُوق	ADJ	created
رَدْح	N	abuse
حَمْد	N	commendation
اِتْفَتَح	V	be_opened
اِتْبَهْدِل	V	be_ridiculed
اِتْسَجَن	V	be_imprisoned
نُعُومَة	N	smoothness
بِلُوفَر	N	Gloss
سَنْد	N	ascription
صُحْبَة	N	company
اِطِّلاع	N	Gloss
أَبَى	V	deny
اِتْقَطَّع	V	be_severed
اِسْتَغْنَى	V	manage_without
رُوسِيّ	ADJ	Russian
صِينِيّ	ADJ	Chinese
وُجُوب	N	duty
فَتْك	N	destruction
قَطَرِيّ	ADJ	Qatari
مَنَى	N	fate
مُهَيْمِن	ADJ	controlling
حَمْد	N	commendation
مُقاوَمَة	N	resistance
قَرَّأ	V	read
نائِب	N	deputy
حَصانَة	N	immunity
قُبَّة	N	dome
رَبْط	N	tying
مُنافِق	N	hypocrite
ثَورَجِي	ADJ	agitated
مُضايِق	ADJ	troublesome
صَحابَة	N	companions_of_the_Prophet
بَرْطَمان	N	glass_jar
إِنْفِعالِي	ADJ	excitable
تَلْجِيم	N	restraining
خَرِيف	N	autumn
أَرْهَق	V	burden
مَحْرُوم	ADJ	deprived
أَكزَخَنَة	N	pharmacy
قَنِيَّة	N	purchase
مُتَهَجِّم	ADJ	attacking
إِكتَشَف	V	discover
حَطِط	ADJ	putting
جَزَّأ	V	divide
أَتَّقَى	V	be_pious
مُهْتَرِئ	ADJ	torn
مُرْسَل	ADJ	sent
كُتْلَة	N	bloc
إِستَقام	V	be_right
بَوس	N	Gloss
عَفْرِيت	N	demon
بالِي	ADJ	disturbing
دَقْنُه	N	Gloss
مُقْرِف	ADJ	disgusting
مِسْتَنِّي	N	waiting
فَشّ	V	cause_to_subside
مِستَوعِب	ADJ	aware
إِهْتَمّ	V	concerened
سِعِد	V	have_the_good_fortune_to
هَيه	N	ha
مُبادَرَة	N	initiative
إِنْتَقَد	V	criticize
اِنْضِباط	N	discipline
قَبَّح	V	disfigure
مِستَبْيَع	ADJ	not_cencerned
مِسْتَبْيَع	ADJ	not_cencerned
قَلَّع	V	pluck_out
مُجاهِد	ADJ	fighting
اِتْحَدَّى	V	challenge
مُنَيَّل	ADJ	dyed_with_indigo
نِيلَة	N	indigo
فاضِي	N	useless
دَورَة	N	championship
حَسَن	ADJ	good
وارِث	N	heir
مِزَعَّل	ADJ	make_sad
هَبّ	V	get_up
دَبّ	V	crawl
أَضَرّ	ADJ	Gloss
تَوِّه	V	mislead
حان	V	arrive
قاسِي	ADJ	harsh
مَسْرُوق	N	stolen_goods
لِبْنانِي	ADJ	lebanese
أَذاع	V	broadcast
جَسَد	N	body
آمَن	V	believe
مُسْمار	N	nail
أَحتَر	V	confused
كِيلُومِتْر	N	kilometer(s)
صَيِّف	V	estivate
مَسْرُوق	ADJ	stolen
نِظامِي	ADJ	orderly
حَرِيقَة	N	fire
خُدْعَة	N	deception
قِوَّة	N	power
حَنِّن	V	sentimentalize
مِترَكَّب	ADJ	formed
تَلْخِيص	N	summary
اِتْفَضَّل	V	be_generous
قِبْطِي	ADJ	Coptic
مِتفَسَّر	ADJ	explained
كِرْش	N	paunch
مُحِيط	N	periphery
مَحْبَس	N	prison
عاز	V	want
مِعْتِمِد	ADJ	Gloss
لَحْمَة	N	soldering_iron
طارِئ	ADJ	emergency
مِتْعَلِّم	ADJ	Gloss
اِستَلَف	V	borrow
اِسْتَلَف	V	borrow
مِحَصَّل	ADJ	cashier
قَصّ	V	cut
عابِد	N	worshipping
فِضِي	V	be_free
تَلات	ADJ	three
حاف	ADJ	by_itself
مُبَذِّر	N	squanderer
طايِر	ADJ	bird
بِخِل	V	greedy
حَوَج	V	let_in_need
سَتْر	N	protection
مُسْرِف	ADJ	excessive
خَطَر	V	oscillate
وَسَّع	V	expand
عَزَم	V	be_determined
مِفَرفِش	ADJ	happy
مِضّايِق	ADJ	troublesome
شِرا	N	purchase
زَنَق	V	constrict
شَيلَة	N	burden
مُدَبِّر	N	manager
مِتْجَدِّد	ADJ	renovated
اِسوِد	ADJ	black
تَرْزِي	N	tailor
تَطْرِيز	N	embroidery
حَوش	N	enclosure
تَوب	N	garment
قَطْعَة	N	stump
قُماشَة	N	Gloss
تَفْصِيلَة	N	detail
سَوَّق	V	market
مُرْبِح	ADJ	lucrative
اَوَى	V	retire
تَم	N	Gloss
قُطْن	N	cotton
مِخَلَّط	N	confused
رَوْعَة	N	alarm
خِياطَة	N	sewing
اِسْتَرْزَق	V	make_a_living
تِجارِيّ	ADJ	commercial
طَبْعَة	N	printing
مُجَمَّد	ADJ	frozen
تَرْبِيَة	N	education
ساق	V	drive
دَواجِن	N	poultry
اَوضَة	N	Gloss
بَلَكَونَة	N	Gloss
غُراب	N	crow
مُسْتَلْزَم	N	requirements
تَصْنِيع	N	fabrication
ماكِينَة	N	machine
نَتْف	N	pulling_out
مَكَنَة	N	instrument
صُغَيُّور	ADJ	small
سادَة	ADJ	simple
مِخَلَّط	ADJ	confused
سَتان	N	satin
كُلْفَة	N	cost
اِقْبال	N	approach
فِرْدَوس	N	paradise
مِتشَكِّر	ADJ	thankful
شِيك	ADJ	graceful
جِراب	N	sack
مُحَرِّض	N	agitator
صارِف	ADJ	Gloss
حَلَوِيّ	N	Gloss
حَيَطان	N	Gloss
كَوم	N	pile
مَقْلُوب	ADJ	turned_over
مَرْحَبا	N	Gloss
شِرْب	N	dried_mud
حَياه	N	Hayat
اَحبَط	V	make_fail
مُسْتَباح	ADJ	Gloss
أَلِّف	V	imagine
مُختَرَق	ADJ	hacked
بَلْطَج	V	become_delinquent
سَرايَة	N	palace
صَفْرا	ADJ	yellow
وَقُود	N	fuel
صَدَّر	V	export
نُقْطَة	N	point
طَرَد	V	expel
بَشَرِي	ADJ	human
رَضَع	V	be_breast-fed
جَون	N	goal
صُرْصار	N	cockroach
سَيِّئَة	N	offense
عِدِم	V	execute
اِعْتِزال	N	retirement
مَيل	N	inclination
لاعِيب	N	players
بُور	N	fallow
نَدالَة	N	baseness
اِعْلامِي	ADJ	information
بُرْتُغالِي	N	Portuguese
حَنّ	V	be_sympathetic_(with)
اِتْبَرَّع	V	contribute
مَدبَحَة	N	massacre
لَخْبَطَة	N	disorder
فَصْل	N	discharge
صُعُود	N	ascent
دِيسَمْبِر	N	December
تَجَوُّل	N	movement
اِسْعاف	N	assistance
مَشْلُول	ADJ	paralyzed
تَمْوِيهِيّ	ADJ	fake
مَقْطُوع	ADJ	cut_off
مُتَصابِي	ADJ	being_infantile
ساكِر	N	Gloss
بَوَّظ	V	corrupt
أَعْجَب	V	delight
مِغْتِرِب	ADJ	expatriate
غَرَّب	V	banish
شَتِّت	V	disperse
شِعْر	N	poetry
اَسقَط	V	he
كَوكَب	N	planet
تايِه	ADJ	lost
صَيف	N	summer
اَعاد	V	re(do)
ثَواب	N	recompense
مُقَولَة	N	contract
اِنْكَرَت	V	gin
تَصْعِيد	N	escalation
مُنْصِف	ADJ	equitable
مِتأَكِّد	ADJ	certain
حَضارِيّ	ADJ	civilized
إِشِي	N	thing
واشِي	N	slanderer
فَقْرَة	N	paragraph
سَلام	N	peace
مُعَبِّر	ADJ	expressing
اَخلَد	V	remain
مَنْظُور	ADJ	perspective
عُثْمانِي	ADJ	Ottoman
بِرِيطانِي	ADJ	british
بُرْتُغالِي	ADJ	Portuguese
مُسْتَعْمِر	ADJ	colonizing
اِسْفِين	N	stake
اِشْتِعال	N	igniting
يَمَنِي	ADJ	Yemeni
كُوَيتِي	ADJ	kuwaiti
فَصِيح	ADJ	eloquent
مُسْتَقْبَلِيّ	ADJ	future
مُتَهالِك	ADJ	broken_down
فَلَكِيّ	ADJ	astronomic
اِحْتِفالِيّ	ADJ	festive
اِتِّحادِي	ADJ	Gloss
كُنْفِدرالِيَّة	N	confederation
إِعتِصام	N	adhering
مِتْشَكِّل	ADJ	Gloss
إِنتقِم	V	take_revenge
بَجاحَة	N	insolence
مُتَقَبِّل	ADJ	accepting
هَدَأ	V	calm_down
مِتْعَمِّد	ADJ	voluntary
فِؤَوِي	ADJ	party
مِسَجِّد	N	Gloss
قِسّ	N	Gloss
مُسْتَخْدَم	ADJ	employed
عَصْرَة	N	a_press
وَزِر	N	minister
بِنْج	N	anesthesia
هِوايَة	N	hobby
حَفْلَة	N	celebration
دِلْوَقْتِي	ADJ	Gloss
تَشْرِيد	N	eviction
اِبْتَغَى	V	want
مِغَمَّض	ADJ	Gloss
اِشتَرَك	V	participate
آدَم	ADJ	human
مَنْح	N	granting
مُمَثِّل	N	representative
مالِيان	ADJ	full_(of)
مالِك	N	proprietor
دَهْشَة	N	surprise
اِسْتِغْراب	N	surprise
شُرُوق	N	sunrise
ناسِب	V	be_compatible_with
نَوعِيَّة	N	characteristic
زَغْرَة	N	Gloss
مُبالَغَة	N	exaggeration
مَحْبُوب	ADJ	mass
هامِشِي	ADJ	peripheral
خُصُوص	ADJ	Gloss
رَعَب	V	be_alarmed
وَلّاعَة	N	lighter
تَخَصُّص	N	specialization
إِستَخَبَّى	V	hide
مَعْهُود	ADJ	contractual
مَحْكُوم	ADJ	governed
مِسْتَخْدِم	N	employing
مُسْتَخْدِم	N	employer
تَحْدِيث	N	updating
دُشّ	N	Gloss
فاتِح	V	disclose
فارِق	V	leave
ذاكِرَة	N	memory
عَضَلَة	N	muscle
اِسْتِسْقاء	N	ascetics
اِنْخِفاض	N	decrease
اِتَّكَل	V	rely_on
وَثَق	V	have_confidence_in
مَخْلُوع	N	deposed
مِتْعاوِن	ADJ	cooperating
اِدْراج	N	insertion
شَبْكَة	N	engagement_jewelry
سَهْم	N	share
اِيمَيل	N	Gloss
مِيعاد	N	promise
اِلْقاء	N	Gloss
شِيُوعِي	N	Communist
فِطار	N	breakfast
سِرْيَة	N	Gloss
عامِّيَّة	N	dialect
ثانِي	ADJ	second
وَزْن	N	weighing
سَطَع	V	shine
بَرّاق	N	shining
باع	N	fathom_(3_meters)
ضارِب	ADJ	hitting
فَرْعِيّ	ADJ	sub-branch
اِهْدار	N	abandoning
بَعَّد	V	Gloss
مَلايكَة	N	angel
هُنا	N	Gloss
قاطِع	V	be_boycotted
أَطال	V	lengthen
بَلُوظَة	N	Gloss
لَقَف	V	seize
تِلْت	N	thirds
خَرْشِم	V	shatter
خَبْطَة	N	blow
شُومَة	N	stick
دِلْوَقْت	N	Gloss
تُرُمّاي	N	tramway_system
أَغْبَر	ADJ	Gloss
مَطَر	N	rain
اِتْنَطَّط	V	jump
أَيُون	N	ion
جَدّ	N	grandfather
رَصِيف	N	sidewalk
مِهْتَمّ	ADJ	interested
مُقْلِق	ADJ	disturbing
مِحاوْلَة	N	attempt
ماسُونِي	ADJ	Freemason
مِيزَة	N	distinguishing_feature
شَمّ	V	smell
رائِحَة	N	odor
عَظَمَة	N	a_bone
تَعْمِير	N	renovation
قافِل	N	coming_home
أاخَذ	V	take
تَسَلُّم	N	receipt
مَطْلَب	N	request
شَرارَة	N	spark
مِصَوَّر	N	photographer
شَهَر	V	declare
ماسُونِيَّة	N	Freemasonry
خالِص	N	pure
مِوَلَّع	ADJ	on_fire
مِرَوَّح	ADJ	Gloss
عَرْكَة	N	fight
اِسْلُوب	N	manner
فَتْن	N	Gloss
ماسُونِيّ	ADJ	Freemason
مُراد	ADJ	desired
حَرِيص	ADJ	eager
غَرْض	N	Gloss
الغَى	V	irradicate
أَمام	N	front
مَزِيد	ADJ	more
اَضاف	V	add
نَقَص	V	decrease
اِخْطار	N	notification
اِعْتَدَى	V	attack
جاهِزِيَة	ADJ	readiness
مَقْصُود	ADJ	deliberate
راهِن	ADJ	present
مُبْتَكَر	ADJ	invented
قَمْحِي	ADJ	wheat
خَير	N	good
بعِد	ADJ	Gloss
مَعالِي	N	Her_Excellency
إِتْنَشَّط	V	Gloss
مُرْتَشِي	ADJ	venomous
كاراتَيه	N	karate
بَرْمِيل	N	barrel
قَهْوَة	N	coffee
دَمْج	N	insertion
مُلْك	N	dominion
دايِم	ADJ	always
دَوّار	ADJ	rotating
مُتَضَرِّر	N	damaged
قَهْرِيّ	ADJ	forced
مَلّا	V	restring
خَرَزانَة	N	Gloss
تَحْسِين	N	improvement
غَرِيبَة	N	oddity
تَسَيُّب	N	neglect
مِفاجِئ	ADJ	surprising
مِعَبَّر	N	expressing
اِباء	N	refusal
عائِق	N	obstacle
تَصالُح	N	reconciliation
تَعَنُّت	N	obstinacy
مُرُونَة	N	flexibility
طَوع	N	voluntarily
مُتَّزِن	ADJ	balanced
مَدْرُوس	ADJ	studied
إِعْتِباطِيّ	ADJ	inquisitorial
أان	N	now
هِنْدِي	N	indians
مُفَتِّش	N	inspector
نَجا	V	escape
اِرْتِكاب	N	perpetration
فِيلْم	N	film
غَرابَة	N	strangeness
رَواج	N	circulation
كاكِي	ADJ	brownish
حَدّ	N	stop
مَأْزَق	N	Gloss
آخِذ	ADJ	taking
صَحَفِي	ADJ	newspaper
أَشْرَف	V	oversee
شَمالِيّ	ADJ	north
نُرْوِيجِيّ	ADJ	Norwegian
سَلَّط	V	impose
ضَوء	N	light
مُسْتَتِر	ADJ	anonymous
سِوِيدِي	ADJ	swedish
عاصِمَة	N	capital_city
كِينِيّ	ADJ	Kenyan
حَبَّة	N	seed
رادْيُو	N	Gloss
كُمّ	N	armhole
اِسم	N	name
فَتِّش	V	look_for
حَتَّى	ADJ	Gloss
مُناصَفَة	N	equal_shares
أَرَجُوز	N	clowns
مُهَرِّج	N	jester
بَهْلَوان	N	acrobat
قادِر	N	expert
مُسْتَبْعَد	ADJ	improbable
شُذُوذ	N	deviation
غَضّ	V	lower
إِسْتِمارَة	N	printed_form
نُبْل	N	nobility
غَيظ	N	anger
اِكْتِساب	N	acquisition
سَماح	N	permission
فَنْجَرَة	N	glaring
اَهلاوِي	ADJ	fan_of_Ahliy_soccer_team
دَوشَة	N	noise
فِنْجان	N	coffee_cup
نِسْكافَيه	N	Gloss
حَجْز	N	detention
صُداع	N	headache
ذِلَّة	N	depravity
مُوالِي	N	partisan
سِباق	N	race
مُتَذَكِّر	ADJ	remembering
اِسْتِبْن	N	spare_wheel
تَوافُقِي	ADJ	congruent
حَصاد	N	Gloss
مُوَقَّع	ADJ	signed
مُلْتَحِي	N	bearded
قَمْعِيّ	ADJ	repressive
خَفا	V	hide
خَرَبان	N	ruins
مِكَثِّف	ADJ	capacitor
مِحايْلَة	N	Gloss
اِتْبَقَّى	V	remain
اِتْسَحَل	V	be_taken_out
غَصَب	V	force
اِبْلِيس	N	devil
اِسْتِشارِي	ADJ	advisory
أَخْلَص	ADJ	Gloss
اِتهَنَّى	V	be_happy
اِطمَئَنّ	V	calm_down
تَلْفِيق	N	concoction
اِدِّعاء	N	allegation
تَبْرِيء	N	Gloss
اِتَّقَّى	V	Gloss
فاسِق	N	adulterer
أَوقَف	V	detain
بُشْرَى	N	symptoms
مَرَه	N	once
اَسْقَط	V	he
شَوْكَة	N	fork
حَلْق	N	shaving
شَمالِيّ	N	north
جَنُوبِيّ	N	south
جار	N	neighbor
دَهيَة	N	disaster
تَرْكِيز	N	emphasis
مُحْتَمَل	ADJ	likely
مُجْتَمِع	ADJ	assembling
إِرثاء	N	consolidation
مُساعِد	N	assistant
مَطْرُوح	ADJ	submitted
مِناقْشَة	N	argument
اِخْتِصاص	N	jurisdiction
اِتْناوِل	V	eat
مُتَتالِي	ADJ	consecutive
مَرْحَباً	N	Gloss
مُتَّصِل	ADJ	continuous
كَفَل	V	support
رَسْمِيّ	ADJ	official
رَحَّب	V	welcome
مِبَكَّر	ADJ	early
مِتْقَدِّم	N	Gloss
سُورِي	ADJ	Syrian
أِختار	V	choose
مَيّال	ADJ	inclined
بَرْضُه	ADJ	Gloss
عاطِفَة	N	emotion
مِتْوافِق	ADJ	Gloss
نَشّ	V	sizzle
دَقْدَقَة	N	Gloss
مُعِين	ADJ	helping
مِتْوَرَّط	ADJ	Gloss
اِتْكَسَر	V	break
طَفَى	V	put_out
مُعَدَّل	ADJ	altered
اَعاذ	V	take_refuge
اِتْقَلَب	V	fall
أَسْفَه	ADJ	more_insolent
طِوِل	V	reach
قاهِرِي	ADJ	Cairene
مِدَبَّر	ADJ	manager
غِه	V	come
مَطْرَح	N	place
لَحَم	V	weld
مُعاقَبَة	N	punishment
جادّ	ADJ	earnest
أَمَرّ	ADJ	more
مُؤْمِنَة	N	Gloss
سِجّادَة	N	carpet
تُوالِيتّ	N	Gloss
قَنْبَلَة	N	bombarding
مِمَشِّي	ADJ	Gloss
مِنافِق	ADJ	sneaky
جَعْجَعَة	N	noise
خَرْطُوشَة	N	cartridges
هَبَل	V	be_crazy
اِرهابِي	ADJ	terrorist
بَدَى	V	seem
حامِد	N	commender
شُوَيَّه	N	a_few
اَفّاق	ADJ	Gloss
نَدْوَة	N	seminar
أَصْل	ADJ	original
هَدَء	V	calm_down
مُتَظاهِر	ADJ	demonstrating
خائِن	N	traitor
هَزَم	V	defeat
اِسمَنتِي	ADJ	cement
آَفَة	N	vice
مِفَكِّك	ADJ	decomposed
فَضَّة	N	silver
مِمَرْمَط	ADJ	spoiling
فِجْلَة	N	radish
ذُبابَة	N	fly
شاط	V	be_burned
خَفّ	V	be_light
وَضْعِيَّة	N	status
عِفِش	ADJ	dirty
اِتْشال	V	be_lifted
سِلْوان	N	charity
شَبَه	N	resemblance
دايْرَة	ADJ	office
مِسْتَعْجِل	ADJ	in_a_hurry
اِتْصَلَح	V	reconcile
مِتْمَسِّك	ADJ	holding
اَمِين	ADJ	faithful
أَباد	V	exterminate
تُورتَة	N	petit_four
مِسَيطَر	ADJ	Gloss
مُتَواطِئ	ADJ	sabdiuing
مِماطْلَة	N	delaying
اِسْتَعْوَض	V	be_substituted
فَدوَة	N	self-sacrifice
مِتحَطَّم	ADJ	destroyed
آَدَمِيَّة	N	human
مِمَهِّد	ADJ	Gloss
شَخْصِيّ	N	Gloss
إِنْتِقالِيّ	ADJ	transitional
جَواب	N	answer
مِلَوَّك	N	Gloss
سَطْو	N	assault
اِزّاي	ADJ	Gloss
إِفْتِعال	N	concocting
مُتَبَرِع	ADJ	contributor
غَلَّة	N	crops
واضِح	N	clear
جَرَّة	N	jar
سايِب	N	leave
آَد	N	child
مَقْصُود	N	purpose
جَماهِيرِي	ADJ	throng
زِيارَة	N	visiting
شَفّاف	ADJ	translucent
مُتَوافِق	ADJ	mutually_agreeing
خَيالِي	ADJ	fictitious
إِجْتِياز	N	overcoming
اَغْلَبِيَّة	N	majority
زُبُون	N	undergarment
مَحْرُوس	ADJ	protected
إِنْتَصَر	V	become_victoious
زَهَق	N	Gloss
أَشْعَر	V	notify
مُتَوَّج	ADJ	crowned
عَدَّة	N	Gloss
المُسْتَدِير	ADJ	circular
غايِب	ADJ	absent
عاشِق	ADJ	fond_of
طَلَقَة	N	shot
آثِم	ADJ	sinful
نال	V	grant
شِهادَة	N	certificate
مَنَح	V	grant
بَراءَة	ADJ	acquittal
طاهِر	ADJ	clean
قُطْب	N	axis
إِغْتال	V	murder
إِغْتِيال	N	murder
آل	N	family
رِثاء	N	mourning
مُحَقِّق	N	investigator
صالِح	V	reconciliate
مُحَفِّز	ADJ	catalyzer
عَبَر	V	cross
إِعْتَرَف	V	confess
بِيانُو	N	piano
سُواقَة	N	subjects
أَجْرَأ	ADJ	more_audacious
مُجَهَّز	ADJ	equipped
خِلْوَة	N	Gloss
اِتْزَنَق	V	crowd
اِسْتَحْسَن	V	select_for_being_better
مَلِك	N	king
مُجْمِع	ADJ	Gloss
اِجْبارِي	ADJ	compulsory
سايِق	N	chauffeur
هِنْدِي	ADJ	Indian
مَرْأَى	N	sight
دَوام	N	duration
فِلِبِّينِي	ADJ	Gloss
مَرْجِع	N	return
مُنْتَظِر	N	waiting
عَطا	V	give
مُبْتَسِم	ADJ	smiling
سِجِلّ	N	register
رَوْعَة	ADJ	magnificence
مُتابِع	ADJ	following
مُكْتَمَل	ADJ	completed
عَيِّلَة	N	baby_girl
إِنْقَطَع	V	be_severed
مَحْمُول	ADJ	carried
فَضائِيّ	ADJ	space
مَلْحَمَة	N	fierce_battle
عَمَّة	N	paternal_aunt
بِدُون	N	Gloss
إِنْتَحَر	V	commit_suicide
دِراع	N	arm
مُنْحَرِف	N	deviant
مَأْكَل	N	eating
تَخْمِيس	N	partnership
سَهَر	N	sleeplessness
اِسْتِماع	N	auditioning
مُثار	ADJ	raised
عَذْبَة	N	Adba
مِقَدِّم	ADJ	skilled
أَلَذّ	ADJ	most_pleasant
اِنْجاز	N	achievements
مَخْصُوص	ADJ	special
مُسَجَّل	ADJ	registered
اِبْلاغ	N	notifications
جَلّاد	N	leather_merchant
جَلْدَة	N	lash
دانِي	ADJ	low
مُشْرِق	ADJ	splendid
اِسْتَحال	V	become_impossible
تَقالِيد	N	customs
اِحْتِكار	N	monopoly
طَبَخ	V	cook
شِقِي	V	work_hard
مالِك	ADJ	possessing
مِلْكِيَّة	N	property
قَرابَة	N	affinity
مُعْفَى	ADJ	exempted
اِقْرار	N	ratification
مِتْشَعَّب	ADJ	versatile
خِلْفَة	N	dissimilarity
حِلْبَة	N	fenugreek
دَورِي	N	league_(sports)
حِزام	N	belt
اِسْتِطْلاع	N	poll_(opinion)
بَسَّط	V	spread
نَقَّط	V	point
بَطَّة	N	Gloss
حَلاوَة	N	sweetness
دَعْبَسَة	N	search
إِزاز	N	Gloss
اِنْحِراف	N	deviation
اِجْرام	N	crime
لامِع	ADJ	splendid
مُقَدِّم	N	presenter
عُضْوِيّ	ADJ	organic
صُلْب	ADJ	hard
تَعَفُّن	N	infection
كِيس	N	sack
مَرْمِي	ADJ	Gloss
مُسابْقَة	N	competition
عَيبَة	N	blemish
جِنَينَة	N	garden
لَذَّة	N	pleasure
شُبّاك	N	window
وَشَك	N	Gloss
اِشْتَبَك	V	quarrel
أَطْرَى	ADJ	Gloss
مَحْطُوط	ADJ	Gloss
اِكْتَفَى	V	have_enough
اِتْحايِل	V	try_convince
كُوَيْتِيّ	ADJ	Kuwaiti
تَلِّم	V	collect
عِلْبَة	N	boxes
كانِز	N	Gloss
بِلاسْتِك	N	plastic
اِتْدَقّ	V	be_minute
اِتْفَضَح	V	be_disgraced
مِتْحَكِّم	ADJ	controlling
راسِب	ADJ	failing
مِطَبَّق	ADJ	applying
مِتْقَسِّم	ADJ	divided
أَدَبِي	ADJ	literary
اِخْتِيارِي	ADJ	elective
فَرَنْسِي	N	Gloss
شَفَوِي	ADJ	Oral
عَمَلِي	ADJ	pragmatic
تَجْوِيد	N	reciting
طَبَق	V	tuck
عَيّان	ADJ	sick
تَجْرِيب	N	trial
أَكادِيمِي	ADJ	academic
قَعَّد	V	serve
خَصَّص	V	specify
حَرَّر	V	liberate
نَواعِم	N	Gloss
اِتْصَدَم	V	strike
شَمُوس	ADJ	rebellious
مُمَوِّل	ADJ	financier
مُفْسِد	N	corrupting
صاعِد	ADJ	ascending
مُقَدَّر	N	estimates
مُتَمَثِّل	ADJ	represented
لَزَّق	V	paste_on
شَنْطَة	N	suitcase
رَجَّة	N	shock
مِسافِر	N	traveler
وَنَس	N	company
طَعْمِيَّة	N	Gloss
وَثِيق	ADJ	secure
اِتصَدَّى	V	confront
مُكَسَّر	ADJ	fragmented
فُوطَة	N	napkin
مِتْعَسَّر	ADJ	difficult
بَرْدان	ADJ	cold
عَمُود	N	column
صابُون	N	soap
هَوّا	V	ventilate
سِتارَة	N	veil
عافِر	V	try
مُخَفَّض	ADJ	reduced
أَنْهَى	V	complete
مُكَيَّف	N	conditioned
مُشَوِّق	ADJ	stimulating
قَطْرَة	N	drop
مَحْصُور	ADJ	blocked
اِتّاكِل	V	be_eaten
جَول	N	goal
قَشّاش	N	non-express
مِقْتِصِر	ADJ	Gloss
مُنْكِر	N	denier
تَقَبََّل	V	Gloss
اِنْدَفَع	V	be_inflamed_with_passion
اِتْرَتِّب	V	be_managed
بَرِيد	N	mail
إِلتَقَى	V	meet
نِكاح	N	marriage
مِيراث	N	inheritance
رَسُول	N	messenger_(Muhammad)
اِيجاب	N	affirmative
صَداق	N	marriage_contract
اِرْتِباط	N	link
اِرْتَبَط	V	be_tied
اِرتَبَط	V	be_tied
اِزْدِواجِيَّة	N	bi-
اِكْتَمَل	V	be_perfect
تَوافُر	N	availability
إِنْفِصال	N	secession
إِنْكِسار	N	dejection
إِكْتِئاب	N	depression
اِنْتِحار	N	suicide
فَوّال	N	beans_vendor
مُعاشَرَة	N	association
جِنْسِيّ	ADJ	sexual
جِنان	N	madness
مَحْشُور	ADJ	stuffed
باط	N	armpit
شُوال	N	sack
مِتْعَذِّب	N	Gloss
وَسَط	N	center
رِخِم	ADJ	thick
نَوَّه	V	allude
طايِق	ADJ	needing
غامِر	V	gamble
اِبْتِداء	N	start
عَنْجَهَة	N	pride
أَدان	N	call_to_prayer
اِتْغَدَّى	V	have_breakfast
رَجّ	V	convulse
خُرافِيّ	ADJ	fictitious
مَرار	N	hardship
اِستَجاب	V	comply
فِطِر	V	be_given_breakfast
رَجْعَة	N	return
عَمار	N	prosperity
مَجْنِي	ADJ	victimized
ضَرِيبِيّ	ADJ	fiscal
صَيْدَلِيَّة	N	pharmacy
اِسْتِثْمارِي	ADJ	Gloss
مُسْتَحْضَر	N	preparation
عَقّار	N	drug
وَرْدِي	ADJ	pink
صَيدَلِيَّة	N	pharmacy
مُنْخَفِض	ADJ	low
لاقِي	N	Gloss
مُهَيَّأ	ADJ	prepared
ذَمْب	N	fault
صَيدَلَة	N	pharmacology
مُرَتَّب	N	salary
مُدافَعَة	N	defense
دِبْلَوم	N	Gloss
تِجارِي	ADJ	commercial
مِوَضَّح	ADJ	Gloss
مُساعِد	ADJ	helping
كَفّ	V	refrain
جَرْد	N	inventory
صَيدَلِي	N	pharmacists
لَيْلِيّ	ADJ	evening
مِرِض	V	be_ill
سِلَّة	N	a_thorn
شَيَطان	N	Gloss
جُمْجُمَة	N	skull
مِقَطْقَط	ADJ	pleasant
اِفْتَرَق	V	differ
مِتَمَّة	N	exact
مِلازِم	N	lieutenant
مَدام	N	madame
فاء	N	Faa
اِعْدادِيَّة	ADJ	Gloss
اِتْدَبِّس	V	Gloss
دادَة	N	governess
شِتا	N	winter
نَفَخ	V	inflate
عَوِّد	V	accustom
مِتابِع	N	following
مُلْزَم	N	obligated
تَجْرِيبِي	ADJ	trial
خُصُوصِي	ADJ	private
مُراجْعَة	N	revision
مُطَلَّقَة	N	divorcee
أَزْهَرِي	ADJ	of
مَلْزَمَة	N	section
صَرَخ	V	shout
مُحْرِج	ADJ	embarrassing
هَزْلِي	ADJ	amusing
عاقِبَة	N	result
سَرْد	N	enumeration
بَسْط	N	spreading
حِضِر	V	Gloss
دُكْتَورَة	N	Gloss
حَبَك	V	weave
فِسْق	N	depravity
مُدْرِك	ADJ	realizing
سَماع	N	hearing
مُطالَبَة	N	requirement
عاكِف	ADJ	assiduous
مُخْتَلِط	ADJ	mixed
اِتْعايِش	V	Gloss
مُحَنَّك	ADJ	experienced
ضَخامَة	N	bulkiness
غَفِير	ADJ	numerous
هَمَجِيّ	ADJ	rude
تَصادُم	N	collision
مُخَطَّط	ADJ	planned
مُتَنَقِّل	ADJ	mobile
أُمْنِيَة	N	wish
خَيِّب	V	disappoint
دَنِمارْكِيّ	ADJ	Danish
سُوِيدِيّ	ADJ	Swedish
صَلَف	N	bragging
عَطْف	N	sympathy
هاجَم	V	attack
بادِر	V	initiate
سَفّاح	N	shedder_of_blood
زاي	N	zay_(Arabic_letter.)
تَقْفِيل	N	Gloss
نائِب	ADJ	representing
سَرِقَة	N	stealing
مَفْرُوغ	ADJ	emptied
مُصادَفَة	N	coincidence
كَفِّن	V	wrap
وَسَّخ	V	pollute
هاي	ADJ	high
شَغّالَة	N	a_servant
شاكِر	ADJ	thankful
مَرْتَع	N	breeding_ground
مُتَّهَمِين	ADJ	suspect
اِسْتِجْواب	N	questioning
مَطْبَعَة	N	printing_press
رِيشَة	N	a_feather
أَسوَد	ADJ	black
خَصْخَصَة	N	privatization
إِنْفِلْوَنْزا	N	influenza
نَضافَة	N	cleanliness
مُحَبَّب	N	agreeable
سِرِنْجَة	N	syringe
مِوَفَّر	ADJ	Gloss
مِقَلَّق	ADJ	Gloss
اِتْبَلَّى	V	defame
طاوِع	V	obey
اِسْتِمالَة	N	making_incline
مُودام	N	Madam
مِطَلَّع	ADJ	Gloss
بَلَى	N	damage
طَقْم	N	collection
حِنِّيَّة	N	bend
مَرَبَّى	N	jam_preserve
تَحْلِيَّة	N	decoration
إِشارَة	N	mentioning
نَشْفان	ADJ	dry
رِيق	N	saliva
لايِم	V	take_easy
شَرْقِي	ADJ	Oriental
مُشادَّة	N	quarrel
اِتْخَدَع	V	deceive
اِنْتَقَد	V	criticise
أَدْلَى	V	provide
مِرايَة	N	mirror
حَظَى	V	benefit
رُقِيّ	N	progress
مَعْدُوم	ADJ	absent
مُبَشِّر	ADJ	preaching
نَبْل	N	arrow
مُعَلِّق	ADJ	commenting
حَدِيدَة	N	iron
مُحافَظَة	N	protection
اِنْدِفاع	N	eruption
مُجْمَل	N	summary
قَبِّل	V	kiss
شَعَر	V	feel
مُتَّجِه	ADJ	heading_towards
هاتِف	ADJ	yelling
دَسْتَة	N	Gloss
مُهْلَة	N	delay
مُحايِد	ADJ	neutral
جَولَة	N	tour
حِمِي	V	defend
مِتْواجِد	ADJ	Gloss
اِزالَة	N	removal
تَذْكارِيّ	ADJ	memorial
أَمِّم	V	nationalize
اِتْظَلَم	V	be_oppressed
سَلْق	N	laceration
كَرِيه	ADJ	unpleasant
خَفِي	ADJ	hidden
قَدِير	N	powerful
مَجْهُول	ADJ	unknown
تِنَّة	N	Gloss
سِحْر	N	sorcery
مَنام	N	sleep
ماهِر	ADJ	skilful
أَسْلَم	V	hand_over
اِعْتَنَق	V	embrace
تَصْوِيب	N	correction
خُصُومَة	N	quarrel
غِيلَة	N	assassination
اِتْشَمْلِل	V	Gloss
إِستَدَلّ	V	quote
صَلِيبِيّ	ADJ	crusade
دَمَوِي	ADJ	blood
عَنِيف	ADJ	fierce
مَملُؤ	ADJ	filled
خادِم	ADJ	serving
شِي	N	thing
